"_id","amount","balance","description","group","name","ref_id","transaction_date","type"
"5c88d8978d9166396db10e23",-74,7680,"Approved order 5c88d7fb8d9166396db10e1f","TA","intrepidtours","00049835","2019-03-13 17:16:55","withdraw"
"5c88d8889e44fa06907ad745",-124,7754,"Approved order 5c88d8308d9166396db10e21","TA","intrepidtours","00049834","2019-03-13 17:16:40","withdraw"
"5c88d87c9e44fa06907ad742",-259,7878,"Approved order 5c88d8569e44fa06907ad740","TA","intrepidtours","00049833","2019-03-13 17:16:28","withdraw"
"5c88d8569e44fa06907ad741",0,8137,"Make an order for an approval","TA","intrepidtours","5c88d8569e44fa06907ad740","2019-03-13 17:15:50","tentative"
"5c88d8308d9166396db10e22",0,8137,"Make an order for an approval","TA","intrepidtours","5c88d8308d9166396db10e21","2019-03-13 17:15:12","tentative"
"5c88d7fb8d9166396db10e20",0,8137,"Make an order for an approval","TA","intrepidtours","5c88d7fb8d9166396db10e1f","2019-03-13 17:14:19","tentative"
"5c88aa569e44fa06907ad66b",-868,8137,"Approved order 5c874f7b8d9166396db1066d","TA","intrepidtours","00049798","2019-03-13 13:59:34","withdraw"
"5c88aa278d9166396db10d4c",-333,9005,"Approved order 5c87516f9e44fa06907acf0d","TA","intrepidtours","00049796","2019-03-13 13:58:47","withdraw"
"5c88aa0d9e44fa06907ad663",-682,9338,"Approved order 5c8771a78d9166396db10733","TA","intrepidtours","00049795","2019-03-13 13:58:21","withdraw"
"5c88a9aa8d9166396db10b6d",-682,10020,"Approved order 5c8716e18d9166396db104ea","TA","intrepidtours","00049792","2019-03-13 13:56:42","withdraw"
"5c88a9948d9166396db10b68",-124,10702,"Approved order 5c88787b9e44fa06907ad2b1","TA","intrepidtours","00049791","2019-03-13 13:56:20","withdraw"
"5c88787b9e44fa06907ad2b2",0,10826,"Make an order for an approval","TA","intrepidtours","5c88787b9e44fa06907ad2b1","2019-03-13 10:26:51","tentative"
"5c885c939e44fa06907ad221",0,10826,"Final settlement","TA","intrepidtours","00049646","2019-03-13 08:27:47","confirmed"
"5c882c4e8d9166396db10882",0,10826,"Final settlement","TA","intrepidtours","00049422","2019-03-13 05:01:50","confirmed"
"5c8788649e44fa06907ad071",-111,10826,"Approved order 5c8788198d9166396db107cb","TA","intrepidtours","00049646","2019-03-12 17:22:28","withdraw"
"5c8788198d9166396db107cc",0,10937,"Make an order for an approval","TA","intrepidtours","5c8788198d9166396db107cb","2019-03-12 17:21:13","tentative"
"5c8771a78d9166396db10734",0,10937,"Make an order for an approval","TA","intrepidtours","5c8771a78d9166396db10733","2019-03-12 15:45:27","tentative"
"5c8759bb8d9166396db106a3",62,10937,"Final ticket change","TA","intrepidtours","00049417","2019-03-12 14:03:23","confirm_refund"
"5c87516f9e44fa06907acf0e",0,10875,"Make an order for an approval","TA","intrepidtours","5c87516f9e44fa06907acf0d","2019-03-12 13:27:59","tentative"
"5c874f7b8d9166396db1066e",0,10875,"Make an order for an approval","TA","intrepidtours","5c874f7b8d9166396db1066d","2019-03-12 13:19:39","tentative"
"5c8716e18d9166396db104eb",0,10875,"Make an order for an approval","TA","intrepidtours","5c8716e18d9166396db104ea","2019-03-12 09:18:09","tentative"
"5c870ce69e44fa06907acd74",0,10875,"Final settlement","TA","intrepidtours","00048589","2019-03-12 08:35:34","confirmed"
"5c870c528d9166396db104a3",0,10875,"Final settlement","TA","intrepidtours","00048588","2019-03-12 08:33:06","confirmed"
"5c870bd88d9166396db104a0",0,10875,"Final settlement","TA","intrepidtours","00048590","2019-03-12 08:31:04","confirmed"
"5c8633f29e44fa06907acb2a",-370,10875,"Approved order 5c8633d59e44fa06907acb27","TA","intrepidtours","00049441","2019-03-11 17:09:54","withdraw"
"5c8633d59e44fa06907acb28",0,11245,"Make an order for an approval","TA","intrepidtours","5c8633d59e44fa06907acb27","2019-03-11 17:09:25","tentative"
"5c862c3b8d9166396db1026c",-148,11245,"Approved order 5c8613788d9166396db101e3","TA","intrepidtours","00049422","2019-03-11 16:36:59","withdraw"
"5c862c298d9166396db10269",-992,11393,"Approved order 5c86265b9e44fa06907aca96","TA","intrepidtours","00049421","2019-03-11 16:36:41","withdraw"
"5c862c0c9e44fa06907acacf",-930,12385,"Approved order 5c8626868d9166396db1023f","TA","intrepidtours","00049419","2019-03-11 16:36:12","withdraw"
"5c862bf19e44fa06907acacc",-682,13315,"Approved order 5c8628478d9166396db10255","TA","intrepidtours","00049418","2019-03-11 16:35:45","withdraw"
"5c862bad9e44fa06907acac7",-930,13997,"Approved order 5c8629b19e44fa06907acab7","TA","intrepidtours","00049417","2019-03-11 16:34:37","withdraw"
"5c862b7b8d9166396db10266",-372,14927,"Approved order 5c862b388d9166396db10263","TA","intrepidtours","00049416","2019-03-11 16:33:47","withdraw"
"5c862b388d9166396db10264",0,15299,"Make an order for an approval","TA","intrepidtours","5c862b388d9166396db10263","2019-03-11 16:32:40","tentative"
"5c8629b19e44fa06907acab8",0,15299,"Make an order for an approval","TA","intrepidtours","5c8629b19e44fa06907acab7","2019-03-11 16:26:09","tentative"
"5c8628478d9166396db10256",0,15299,"Make an order for an approval","TA","intrepidtours","5c8628478d9166396db10255","2019-03-11 16:20:07","tentative"
"5c8626868d9166396db10240",0,15299,"Make an order for an approval","TA","intrepidtours","5c8626868d9166396db1023f","2019-03-11 16:12:38","tentative"
"5c86265b9e44fa06907aca97",0,15299,"Make an order for an approval","TA","intrepidtours","5c86265b9e44fa06907aca96","2019-03-11 16:11:55","tentative"
"5c861ff48d9166396db1022c",0,15299,"Update an order","TA","intrepidtours","00048590","2019-03-11 15:44:36","extra"
"5c8613788d9166396db101e4",0,15299,"Make an order for an approval","TA","intrepidtours","5c8613788d9166396db101e3","2019-03-11 14:51:20","tentative"
"5c85b8d19e44fa06907ac827",0,15299,"Final settlement","TA","intrepidtours","00048443","2019-03-11 08:24:33","confirmed"
"5c85b82e8d9166396db0ff5a",0,15299,"Final settlement","TA","intrepidtours","00048587","2019-03-11 08:21:50","confirmed"
"5c85b7a88d9166396db0ff49",0,15299,"Final settlement","TA","intrepidtours","00049176","2019-03-11 08:19:36","confirmed"
"5c85ae299e44fa06907ac79b",0,15299,"Update an order","TA","intrepidtours","00048587","2019-03-11 07:39:05","extra"
"5c85acd89e44fa06907ac796",0,15299,"Update an order","TA","intrepidtours","00049176","2019-03-11 07:33:28","extra"
"5c8495429e44fa06907ac555",0,15299,"Final settlement","TA","intrepidtours","00048438","2019-03-10 11:40:34","confirmed"
"5c8474529e44fa06907ac4cc",0,15299,"Final settlement","TA","intrepidtours","00049175","2019-03-10 09:20:02","confirmed"
"5c846de18d9166396db0fbc6",-111,15299,"Approved order 5c838a819e44fa06907ac1d5","TA","intrepidtours","00049176","2019-03-10 08:52:33","withdraw"
"5c846dcd8d9166396db0fbc3",-74,15410,"Approved order 5c846d819e44fa06907ac4b3","TA","intrepidtours","00049175","2019-03-10 08:52:13","withdraw"
"5c846d819e44fa06907ac4b4",0,15484,"Make an order for an approval","TA","intrepidtours","5c846d819e44fa06907ac4b3","2019-03-10 08:50:57","tentative"
"5c846b3f9e44fa06907ac49d",148,15484,"Final ticket change","TA","intrepidtours","00048586","2019-03-10 08:41:19","confirm_refund"
"5c8460e68d9166396db0faf3",0,15336,"Final settlement","TA","intrepidtours","00048444","2019-03-10 07:57:10","confirmed"
"5c84395f8d9166396db0fa1d",0,15336,"Final settlement","TA","intrepidtours","00048439","2019-03-10 05:08:31","confirmed"
"5c838a819e44fa06907ac1d6",0,15336,"Make an order for an approval","TA","intrepidtours","5c838a819e44fa06907ac1d5","2019-03-09 16:42:25","tentative"
"5c831f928d9166396db0f5a6",74,15336,"Final ticket change","TA","intrepidtours","00048948","2019-03-09 09:06:10","confirm_refund"
"5c831a048d9166396db0f568",0,15262,"Split ticket","TA","intrepidtours","00048584","2019-03-09 08:42:28","split_confirmed"
"5c831a048d9166396db0f56a",0,15262,"Split order from 00048584","TA","intrepidtours","00048948","2019-03-09 08:42:28","split"
"5c8318779e44fa06907abd99",0,15262,"Final settlement","TA","intrepidtours","00048585","2019-03-09 08:35:51","confirmed"
"5c830af48d9166396db0f492",0,15262,"Final settlement","TA","intrepidtours","00048437","2019-03-09 07:38:12","confirmed"
"5c8308998d9166396db0f473",-37,15262,"Update an order","TA","intrepidtours","00048584","2019-03-09 07:28:09","extra"
"5c82e8749e44fa06907abc4e",0,15299,"Final settlement","TA","intrepidtours","00048440","2019-03-09 05:11:00","confirmed"
"5c823bd98d9166396db0f2d1",0,15299,"Final settlement","TA","intrepidtours","00048178","2019-03-08 16:54:33","confirmed"
"5c822cd78d9166396db0f277",0,15299,"Final settlement","TA","intrepidtours","00048183","2019-03-08 15:50:31","confirmed"
"5c81c4f69e44fa06907ab880",0,15299,"Final settlement","TA","intrepidtours","00048056","2019-03-08 08:27:18","confirmed"
"5c81c4c98d9166396db0f04a",0,15299,"Final settlement","TA","intrepidtours","00048583","2019-03-08 08:26:33","confirmed"
"5c81c4ab8d9166396db0f048",111,15299,"Final ticket change","TA","intrepidtours","00048582","2019-03-08 08:26:03","confirm_refund"
"5c81bd3d9e44fa06907ab841",0,15188,"Final settlement","TA","intrepidtours","00048057","2019-03-08 07:54:21","confirmed"
"5c81b99f9e44fa06907ab82f",111,15188,"Final ticket change","TA","intrepidtours","00048442","2019-03-08 07:38:55","confirm_refund"
"5c80ea118d9166396db0ee53",0,15077,"Final settlement","TA","intrepidtours","00048055","2019-03-07 16:53:21","confirmed"
"5c80bc3c8d9166396db0ecef",0,15077,"Final settlement","TA","intrepidtours","00048441","2019-03-07 13:37:48","confirmed"
"5c80a6dc9e44fa06907ab4ea",-185,15077,"Approved order 5c807d7c8d9166396db0eb41","TA","intrepidtours","00048590","2019-03-07 12:06:36","withdraw"
"5c80a6d48d9166396db0ec61",-186,15262,"Approved order 5c807d4f9e44fa06907ab3d9","TA","intrepidtours","00048589","2019-03-07 12:06:28","withdraw"
"5c80a6cc9e44fa06907ab4e7",-296,15448,"Approved order 5c807d2a8d9166396db0eb3c","TA","intrepidtours","00048588","2019-03-07 12:06:20","withdraw"
"5c80a6c29e44fa06907ab4e4",-124,15744,"Approved order 5c807c7d9e44fa06907ab3ca","TA","intrepidtours","00048587","2019-03-07 12:06:10","withdraw"
"5c80a6b99e44fa06907ab4dd",-185,15868,"Approved order 5c807c449e44fa06907ab3c4","TA","intrepidtours","00048586","2019-03-07 12:06:01","withdraw"
"5c80a6b08d9166396db0ec5e",-124,16053,"Approved order 5c807bde9e44fa06907ab3bf","TA","intrepidtours","00048585","2019-03-07 12:05:52","withdraw"
"5c80a6a69e44fa06907ab4da",-296,16177,"Approved order 5c807bae9e44fa06907ab3b9","TA","intrepidtours","00048584","2019-03-07 12:05:42","withdraw"
"5c80a69b8d9166396db0ec5b",-74,16473,"Approved order 5c807b408d9166396db0eb2c","TA","intrepidtours","00048583","2019-03-07 12:05:31","withdraw"
"5c80a68a8d9166396db0ec58",-185,16547,"Approved order 5c807b179e44fa06907ab3af","TA","intrepidtours","00048582","2019-03-07 12:05:14","withdraw"
"5c807d7c8d9166396db0eb42",0,16732,"Make an order for an approval","TA","intrepidtours","5c807d7c8d9166396db0eb41","2019-03-07 09:10:04","tentative"
"5c807d4f9e44fa06907ab3da",0,16732,"Make an order for an approval","TA","intrepidtours","5c807d4f9e44fa06907ab3d9","2019-03-07 09:09:19","tentative"
"5c807d2a8d9166396db0eb3d",0,16732,"Make an order for an approval","TA","intrepidtours","5c807d2a8d9166396db0eb3c","2019-03-07 09:08:42","tentative"
"5c807c7d9e44fa06907ab3cb",0,16732,"Make an order for an approval","TA","intrepidtours","5c807c7d9e44fa06907ab3ca","2019-03-07 09:05:49","tentative"
"5c807c449e44fa06907ab3c5",0,16732,"Make an order for an approval","TA","intrepidtours","5c807c449e44fa06907ab3c4","2019-03-07 09:04:52","tentative"
"5c807bde9e44fa06907ab3c0",0,16732,"Make an order for an approval","TA","intrepidtours","5c807bde9e44fa06907ab3bf","2019-03-07 09:03:10","tentative"
"5c807bae9e44fa06907ab3ba",0,16732,"Make an order for an approval","TA","intrepidtours","5c807bae9e44fa06907ab3b9","2019-03-07 09:02:22","tentative"
"5c807b408d9166396db0eb2d",0,16732,"Make an order for an approval","TA","intrepidtours","5c807b408d9166396db0eb2c","2019-03-07 09:00:32","tentative"
"5c807b179e44fa06907ab3b0",0,16732,"Make an order for an approval","TA","intrepidtours","5c807b179e44fa06907ab3af","2019-03-07 08:59:51","tentative"
"5c8075cc9e44fa06907ab36a",0,16732,"Final settlement","TA","intrepidtours","00048060","2019-03-07 08:37:16","confirmed"
"5c8071059e44fa06907ab317",74,16732,"Final ticket change","TA","intrepidtours","00048271","2019-03-07 08:16:53","confirm_refund"
"5c8070b79e44fa06907ab30c",0,16658,"Final settlement","TA","intrepidtours","00048272","2019-03-07 08:15:35","confirmed"
"5c805c468d9166396db0e9f4",0,16658,"Final settlement","TA","intrepidtours","00048059","2019-03-07 06:48:22","confirmed"
"5c80482c9e44fa06907ab22d",0,16658,"Final settlement","TA","intrepidtours","00048061","2019-03-07 05:22:36","confirmed"
"5c7fae108d9166396db0e900",62,16658,"Update an order","TA","intrepidtours","00048055","2019-03-06 18:25:04","refund"
"5c7f9c328d9166396db0e8d7",-37,16596,"Update an order","TA","intrepidtours","00048271","2019-03-06 17:08:50","extra"
"5c7f8fbf9e44fa06907ab10c",0,16633,"Final settlement","TA","intrepidtours","00048058","2019-03-06 16:15:43","confirmed"
"5c7f856e8d9166396db0e839",-620,16633,"Approved order 5c7f461d8d9166396db0e6c2","TA","intrepidtours","00048444","2019-03-06 15:31:42","withdraw"
"5c7f85518d9166396db0e836",-744,17253,"Approved order 5c7f46408d9166396db0e6c4","TA","intrepidtours","00048443","2019-03-06 15:31:13","withdraw"
"5c7f85298d9166396db0e833",-444,17997,"Approved order 5c7f4a759e44fa06907aaf8b","TA","intrepidtours","00048442","2019-03-06 15:30:33","withdraw"
"5c7f82af9e44fa06907ab0d4",-434,18441,"Approved order 5c7f4f5f8d9166396db0e6f3","TA","intrepidtours","00048441","2019-03-06 15:19:59","withdraw"
"5c7f82a58d9166396db0e82b",-124,18875,"Approved order 5c7f53919e44fa06907aafb2","TA","intrepidtours","00048440","2019-03-06 15:19:49","withdraw"
"5c7f82979e44fa06907ab0d1",-259,18999,"Approved order 5c7f74ad8d9166396db0e7b6","TA","intrepidtours","00048439","2019-03-06 15:19:35","withdraw"
"5c7f826d8d9166396db0e827",-372,19258,"Approved order 5c7f758a9e44fa06907ab06c","TA","intrepidtours","00048438","2019-03-06 15:18:53","withdraw"
"5c7f81ee8d9166396db0e823",-558,19630,"Approved order 5c7f786c9e44fa06907ab07e","TA","intrepidtours","00048437","2019-03-06 15:16:46","withdraw"
"5c7f786c9e44fa06907ab07f",0,20188,"Make an order for an approval","TA","intrepidtours","5c7f786c9e44fa06907ab07e","2019-03-06 14:36:12","tentative"
"5c7f758a9e44fa06907ab06d",0,20188,"Make an order for an approval","TA","intrepidtours","5c7f758a9e44fa06907ab06c","2019-03-06 14:23:54","tentative"
"5c7f74ad8d9166396db0e7b7",0,20188,"Make an order for an approval","TA","intrepidtours","5c7f74ad8d9166396db0e7b6","2019-03-06 14:20:13","tentative"
"5c7f53919e44fa06907aafb3",0,20188,"Make an order for an approval","TA","intrepidtours","5c7f53919e44fa06907aafb2","2019-03-06 11:58:57","tentative"
"5c7f4f5f8d9166396db0e6f4",0,20188,"Make an order for an approval","TA","intrepidtours","5c7f4f5f8d9166396db0e6f3","2019-03-06 11:41:03","tentative"
"5c7f4dac8d9166396db0e6e6",62,20188,"Cancel order","TA","intrepidtours","00047950","2019-03-06 11:33:48","refund"
"5c7f4b8f9e44fa06907aaf8d",0,20126,"Final settlement","TA","intrepidtours","00048182","2019-03-06 11:24:47","confirmed"
"5c7f4a759e44fa06907aaf8c",0,20126,"Make an order for an approval","TA","intrepidtours","5c7f4a759e44fa06907aaf8b","2019-03-06 11:20:05","tentative"
"5c7f46408d9166396db0e6c5",0,20126,"Make an order for an approval","TA","intrepidtours","5c7f46408d9166396db0e6c4","2019-03-06 11:02:08","tentative"
"5c7f461d8d9166396db0e6c3",0,20126,"Make an order for an approval","TA","intrepidtours","5c7f461d8d9166396db0e6c2","2019-03-06 11:01:33","tentative"
"5c7f20e28d9166396db0e5b1",0,20126,"Final settlement","TA","intrepidtours","00047572","2019-03-06 08:22:42","confirmed"
"5c7f18cc9e44fa06907aae19",0,20126,"Final settlement","TA","intrepidtours","00048270","2019-03-06 07:48:12","confirmed"
"5c7e52ad9e44fa06907aaceb",-186,20126,"Approved order 5c7e52a19e44fa06907aace9","TA","intrepidtours","00048272","2019-03-05 17:42:53","withdraw"
"5c7e52a19e44fa06907aacea",0,20312,"Make an order for an approval","TA","intrepidtours","5c7e52a19e44fa06907aace9","2019-03-05 17:42:41","tentative"
"5c7e52958d9166396db0e424",-74,20312,"Approved order 5c7e52828d9166396db0e422","TA","intrepidtours","00048271","2019-03-05 17:42:29","withdraw"
"5c7e52828d9166396db0e423",0,20386,"Make an order for an approval","TA","intrepidtours","5c7e52828d9166396db0e422","2019-03-05 17:42:10","tentative"
"5c7e52678d9166396db0e41f",-37,20386,"Approved order 5c7e52399e44fa06907aace6","TA","intrepidtours","00048270","2019-03-05 17:41:43","withdraw"
"5c7e52399e44fa06907aace7",0,20423,"Make an order for an approval","TA","intrepidtours","5c7e52399e44fa06907aace6","2019-03-05 17:40:57","tentative"
"5c7e09b59e44fa06907aaa57",0,20423,"Final settlement","TA","intrepidtours","00047569","2019-03-05 12:31:33","confirmed"
"5c7df1818d9166396db0e223",-124,20423,"Approved order 5c7df11a8d9166396db0e21a","TA","intrepidtours","00048183","2019-03-05 10:48:17","withdraw"
"5c7df1789e44fa06907aa9d9",-124,20547,"Approved order 5c7df1578d9166396db0e21d","TA","intrepidtours","00048182","2019-03-05 10:48:08","withdraw"
"5c7df1578d9166396db0e21e",0,20671,"Make an order for an approval","TA","intrepidtours","5c7df1578d9166396db0e21d","2019-03-05 10:47:35","tentative"
"5c7df11a8d9166396db0e21b",0,20671,"Make an order for an approval","TA","intrepidtours","5c7df11a8d9166396db0e21a","2019-03-05 10:46:34","tentative"
"5c7dea308d9166396db0e208",-868,20671,"Approved order 5c7de7fa8d9166396db0e11c","TA","intrepidtours","00048178","2019-03-05 10:17:04","withdraw"
"5c7de7fa8d9166396db0e11d",0,21539,"Make an order for an approval","TA","intrepidtours","5c7de7fa8d9166396db0e11c","2019-03-05 10:07:38","tentative"
"5c7dd0198d9166396db0e057",0,21539,"Final settlement","TA","intrepidtours","00048070","2019-03-05 08:25:45","confirmed"
"5c7dcb1e9e44fa06907aa5c2",-74,21539,"Update an order","TA","intrepidtours","00048070","2019-03-05 08:04:30","extra"
"5c7d007d9e44fa06907aa459",-148,21613,"Approved order 5c7d00609e44fa06907aa455","TA","intrepidtours","00048070","2019-03-04 17:39:57","withdraw"
"5c7d00609e44fa06907aa456",0,21761,"Make an order for an approval","TA","intrepidtours","5c7d00609e44fa06907aa455","2019-03-04 17:39:28","tentative"
"5c7cf7549e44fa06907aa42d",-407,21761,"Approved order 5c7c9c7d8d9166396db0dc99","TA","intrepidtours","00048061","2019-03-04 17:00:52","withdraw"
"5c7cf7359e44fa06907aa42a",-744,22168,"Approved order 5c7cda508d9166396db0dd80","TA","intrepidtours","00048060","2019-03-04 17:00:21","withdraw"
"5c7cf6a78d9166396db0de0e",-930,22912,"Approved order 5c7cdac39e44fa06907aa37d","TA","intrepidtours","00048059","2019-03-04 16:57:59","withdraw"
"5c7cf6979e44fa06907aa427",-333,23842,"Approved order 5c7cdae59e44fa06907aa37f","TA","intrepidtours","00048058","2019-03-04 16:57:43","withdraw"
"5c7cf64f9e44fa06907aa424",-930,24175,"Approved order 5c7cdaed8d9166396db0dd83","TA","intrepidtours","00048057","2019-03-04 16:56:31","withdraw"
"5c7cf5ba8d9166396db0de0a",-868,25105,"Approved order 5c7cdb539e44fa06907aa382","TA","intrepidtours","00048056","2019-03-04 16:54:02","withdraw"
"5c7cf5a59e44fa06907aa41d",-868,25973,"Approved order 5c7cdb9a9e44fa06907aa384","TA","intrepidtours","00048055","2019-03-04 16:53:41","withdraw"
"5c7cdb9a9e44fa06907aa385",0,26841,"Make an order for an approval","TA","intrepidtours","5c7cdb9a9e44fa06907aa384","2019-03-04 15:02:34","tentative"
"5c7cdb539e44fa06907aa383",0,26841,"Make an order for an approval","TA","intrepidtours","5c7cdb539e44fa06907aa382","2019-03-04 15:01:23","tentative"
"5c7cdaed8d9166396db0dd84",0,26841,"Make an order for an approval","TA","intrepidtours","5c7cdaed8d9166396db0dd83","2019-03-04 14:59:41","tentative"
"5c7cdae59e44fa06907aa380",0,26841,"Make an order for an approval","TA","intrepidtours","5c7cdae59e44fa06907aa37f","2019-03-04 14:59:33","tentative"
"5c7cdac39e44fa06907aa37e",0,26841,"Make an order for an approval","TA","intrepidtours","5c7cdac39e44fa06907aa37d","2019-03-04 14:58:59","tentative"
"5c7cda508d9166396db0dd81",0,26841,"Make an order for an approval","TA","intrepidtours","5c7cda508d9166396db0dd80","2019-03-04 14:57:04","tentative"
"5c7c9c7d8d9166396db0dc9a",0,26841,"Make an order for an approval","TA","intrepidtours","5c7c9c7d8d9166396db0dc99","2019-03-04 10:33:17","tentative"
"5c7c834b9e44fa06907aa1d9",0,26841,"Final settlement","TA","intrepidtours","00047592","2019-03-04 08:45:47","confirmed"
"5c7c83158d9166396db0dbee",74,26841,"Update an order","TA","intrepidtours","00047592","2019-03-04 08:44:53","refund"
"5c7c812b9e44fa06907aa1c2",0,26767,"Final settlement","TA","intrepidtours","00047593","2019-03-04 08:36:43","confirmed"
"5c7c7fbe9e44fa06907aa19b",0,26767,"Split ticket","TA","intrepidtours","00047570","2019-03-04 08:30:38","split_confirmed"
"5c7c7fbe9e44fa06907aa19e",0,26767,"Split order from 00047570","TA","intrepidtours","00047950","2019-03-04 08:30:38","split"
"5c7c77a38d9166396db0db29",0,26767,"Final settlement","TA","intrepidtours","00047573","2019-03-04 07:56:03","confirmed"
"5c7c70e28d9166396db0daeb",0,26767,"Final settlement","TA","intrepidtours","00047585","2019-03-04 07:27:14","confirmed"
"5c7b2c728d9166396db0d7ab",0,26767,"Final settlement","TA","intrepidtours","00047591","2019-03-03 08:22:58","confirmed"
"5c7b2c128d9166396db0d7a1",124,26767,"Final ticket change","TA","intrepidtours","00047571","2019-03-03 08:21:22","confirm_refund"
"5c7afde58d9166396db0d6be",0,26643,"Final settlement","TA","intrepidtours","00047111","2019-03-03 05:04:21","confirmed"
"5c7a30b89e44fa06907a9af9",0,26643,"Final settlement","TA","intrepidtours","00047583","2019-03-02 14:28:56","confirmed"
"5c79eacd8d9166396db0d398",-62,26643,"Update an order","TA","intrepidtours","00047571","2019-03-02 09:30:37","extra"
"5c79dcd49e44fa06907a98d4",0,26705,"Final settlement","TA","intrepidtours","00047109","2019-03-02 08:31:00","confirmed"
"5c79d7d19e44fa06907a989d",0,26705,"Final settlement","TA","intrepidtours","00047590","2019-03-02 08:09:37","confirmed"
"5c78fa328d9166396db0d073",-124,26705,"Approved order 5c78f6f89e44fa06907a964a","TA","intrepidtours","00047593","2019-03-01 16:24:02","withdraw"
"5c78fa228d9166396db0d070",-148,26829,"Approved order 5c78f62f8d9166396db0d053","TA","intrepidtours","00047592","2019-03-01 16:23:46","withdraw"
"5c78fa129e44fa06907a9663",-111,26977,"Approved order 5c78f5f59e44fa06907a9647","TA","intrepidtours","00047591","2019-03-01 16:23:30","withdraw"
"5c78fa048d9166396db0d06d",-222,27088,"Approved order 5c78f56b8d9166396db0d051","TA","intrepidtours","00047590","2019-03-01 16:23:16","withdraw"
"5c78f6f89e44fa06907a964b",0,27310,"Make an order for an approval","TA","intrepidtours","5c78f6f89e44fa06907a964a","2019-03-01 16:10:16","tentative"
"5c78f62f8d9166396db0d054",0,27310,"Make an order for an approval","TA","intrepidtours","5c78f62f8d9166396db0d053","2019-03-01 16:06:55","tentative"
"5c78f5f59e44fa06907a9648",0,27310,"Make an order for an approval","TA","intrepidtours","5c78f5f59e44fa06907a9647","2019-03-01 16:05:57","tentative"
"5c78f56b8d9166396db0d052",0,27930,"Make an order for an approval","TA","intrepidtours","5c78f56b8d9166396db0d051","2019-03-01 16:03:39","tentative"
"5c78f56b9e44fa06907a9644",-620,27310,"Approved order 5c78f4fa8d9166396db0d04d","TA","intrepidtours","00047585","2019-03-01 16:03:39","withdraw"
"5c78f4fa8d9166396db0d04e",0,27930,"Make an order for an approval","TA","intrepidtours","5c78f4fa8d9166396db0d04d","2019-03-01 16:01:46","tentative"
"5c78f4568d9166396db0d04a",-124,27930,"Approved order 5c7899cf8d9166396db0cd63","TA","intrepidtours","00047583","2019-03-01 15:59:02","withdraw"
"5c78f04a9e44fa06907a9612",-620,28054,"Approved order 5c78ae449e44fa06907a933f","TA","intrepidtours","00047573","2019-03-01 15:41:46","withdraw"
"5c78f0349e44fa06907a960f",-620,28674,"Approved order 5c78b0db8d9166396db0ce94","TA","intrepidtours","00047572","2019-03-01 15:41:24","withdraw"
"5c78effd9e44fa06907a960c",-1054,29294,"Approved order 5c78b20a8d9166396db0ce9f","TA","intrepidtours","00047571","2019-03-01 15:40:29","withdraw"
"5c78efca8d9166396db0d018",-620,30348,"Approved order 5c78ee368d9166396db0d00e","TA","intrepidtours","00047570","2019-03-01 15:39:38","withdraw"
"5c78efa58d9166396db0d015",-222,30968,"Approved order 5c78ee878d9166396db0d010","TA","intrepidtours","00047569","2019-03-01 15:39:01","withdraw"
"5c78ee878d9166396db0d011",0,31190,"Make an order for an approval","TA","intrepidtours","5c78ee878d9166396db0d010","2019-03-01 15:34:15","tentative"
"5c78ee368d9166396db0d00f",0,31190,"Make an order for an approval","TA","intrepidtours","5c78ee368d9166396db0d00e","2019-03-01 15:32:54","tentative"
"5c78ebee8d9166396db0d004",0,31190,"Final settlement","TA","intrepidtours","00047108","2019-03-01 15:23:10","confirmed"
"5c78b20a8d9166396db0cea0",0,31190,"Make an order for an approval","TA","intrepidtours","5c78b20a8d9166396db0ce9f","2019-03-01 11:16:10","tentative"
"5c78b0db8d9166396db0ce95",0,31190,"Make an order for an approval","TA","intrepidtours","5c78b0db8d9166396db0ce94","2019-03-01 11:11:07","tentative"
"5c78ae449e44fa06907a9340",0,31190,"Make an order for an approval","TA","intrepidtours","5c78ae449e44fa06907a933f","2019-03-01 11:00:04","tentative"
"5c7899cf8d9166396db0cd64",0,31190,"Make an order for an approval","TA","intrepidtours","5c7899cf8d9166396db0cd63","2019-03-01 09:32:47","tentative"
"5c78924f9e44fa06907a92bb",0,31190,"Final settlement","TA","intrepidtours","00047117","2019-03-01 09:00:47","confirmed"
"5c7890ca9e44fa06907a92a7",0,31190,"Final settlement","TA","intrepidtours","00047118","2019-03-01 08:54:18","confirmed"
"5c788ecc8d9166396db0ccfc",0,31190,"Final settlement","TA","intrepidtours","00047119","2019-03-01 08:45:48","confirmed"
"5c788caf9e44fa06907a9255",62,31190,"Update an order","TA","intrepidtours","00047118","2019-03-01 08:36:47","refund"
"5c788adc8d9166396db0ccb6",74,31128,"Update an order","TA","intrepidtours","00047119","2019-03-01 08:29:00","refund"
"5c788a369e44fa06907a922b",0,31054,"Final settlement","TA","intrepidtours","00046666","2019-03-01 08:26:14","confirmed"
"5c77b7d38d9166396db0ca50",-111,31054,"Update an order","TA","intrepidtours","00047119","2019-02-28 17:28:35","extra"
"5c7790218d9166396db0c8b7",20000,31165,"Make a deposit","TA","intrepidtours","ANZ 312560 (28/02/2019)","2019-02-28 14:39:13","deposit"
"5c776c8d8d9166396db0c829",0,11165,"Final settlement","TA","intrepidtours","00046669","2019-02-28 12:07:25","confirmed"
"5c7740399e44fa06907a8cfb",0,11165,"Final settlement","TA","intrepidtours","00046688","2019-02-28 08:58:17","confirmed"
"5c773b8e8d9166396db0c6d8",0,11165,"Final settlement","TA","intrepidtours","00047116","2019-02-28 08:38:22","confirmed"
"5c773a228d9166396db0c6b8",37,11165,"Update an order","TA","intrepidtours","00047116","2019-02-28 08:32:18","refund"
"5c7738c59e44fa06907a8c84",0,11128,"Final settlement","TA","intrepidtours","00046672","2019-02-28 08:26:29","confirmed"
"5c7738469e44fa06907a8c7d",0,11128,"Final settlement","TA","intrepidtours","00046689","2019-02-28 08:24:22","confirmed"
"5c7666629e44fa06907a8aaa",-148,11128,"Approved order 5c7666449e44fa06907a8aa5","TA","intrepidtours","00047119","2019-02-27 17:28:50","withdraw"
"5c7666519e44fa06907a8aa7",-372,11276,"Approved order 5c7666238d9166396db0c4e0","TA","intrepidtours","00047118","2019-02-27 17:28:33","withdraw"
"5c7666449e44fa06907a8aa6",0,11648,"Make an order for an approval","TA","intrepidtours","5c7666449e44fa06907a8aa5","2019-02-27 17:28:20","tentative"
"5c7666389e44fa06907a8aa2",-222,11648,"Approved order 5c7664d09e44fa06907a8aa0","TA","intrepidtours","00047117","2019-02-27 17:28:08","withdraw"
"5c76662c8d9166396db0c4e2",-111,11870,"Approved order 5c7664a39e44fa06907a8a9e","TA","intrepidtours","00047116","2019-02-27 17:27:56","withdraw"
"5c7666238d9166396db0c4e1",0,11981,"Make an order for an approval","TA","intrepidtours","5c7666238d9166396db0c4e0","2019-02-27 17:27:47","tentative"
"5c7664d09e44fa06907a8aa1",0,11981,"Make an order for an approval","TA","intrepidtours","5c7664d09e44fa06907a8aa0","2019-02-27 17:22:08","tentative"
"5c7664a39e44fa06907a8a9f",0,11981,"Make an order for an approval","TA","intrepidtours","5c7664a39e44fa06907a8a9e","2019-02-27 17:21:23","tentative"
"5c7659ec8d9166396db0c4b1",-481,11981,"Approved order 5c7659199e44fa06907a8a63","TA","intrepidtours","00047111","2019-02-27 16:35:40","withdraw"
"5c7659199e44fa06907a8a64",0,12462,"Make an order for an approval","TA","intrepidtours","5c7659199e44fa06907a8a63","2019-02-27 16:32:09","tentative"
"5c7657418d9166396db0c4a6",-434,12462,"Approved order 5c76541f9e44fa06907a8a51","TA","intrepidtours","00047109","2019-02-27 16:24:17","withdraw"
"5c7657329e44fa06907a8a5f",-144,12896,"Approved order 5c7655bf8d9166396db0c4a1","TA","intrepidtours","00047108","2019-02-27 16:24:02","withdraw"
"5c7655bf8d9166396db0c4a2",0,13040,"Make an order for an approval","TA","intrepidtours","5c7655bf8d9166396db0c4a1","2019-02-27 16:17:51","tentative"
"5c76541f9e44fa06907a8a52",0,13040,"Make an order for an approval","TA","intrepidtours","5c76541f9e44fa06907a8a51","2019-02-27 16:10:55","tentative"
"5c763ff98d9166396db0c436",0,13040,"Final settlement","TA","intrepidtours","00046667","2019-02-27 14:44:57","confirmed"
"5c762f118d9166396db0c3eb",74,13040,"Final ticket change","TA","intrepidtours","00046668","2019-02-27 13:32:49","confirm_refund"
"5c75ee979e44fa06907a870a",0,12966,"Final settlement","TA","intrepidtours","00046698","2019-02-27 08:57:43","confirmed"
"5c75ede78d9166396db0c228",0,12966,"Final settlement","TA","intrepidtours","00046670","2019-02-27 08:54:47","confirmed"
"5c75ecaf8d9166396db0c216",0,12966,"Final settlement","TA","intrepidtours","00046697","2019-02-27 08:49:35","confirmed"
"5c75ebe19e44fa06907a86f3",74,12966,"Update an order","TA","intrepidtours","00046697","2019-02-27 08:46:09","refund"
"5c75e8229e44fa06907a86bb",0,12892,"Final settlement","TA","intrepidtours","00046696","2019-02-27 08:30:10","confirmed"
"5c75e7399e44fa06907a86aa",0,12892,"Final settlement","TA","intrepidtours","00046193","2019-02-27 08:26:17","confirmed"
"5c75e72a9e44fa06907a86a6",-259,12892,"Update an order","TA","intrepidtours","00046697","2019-02-27 08:26:02","extra"
"5c75e6048d9166396db0c19d",148,13151,"Update an order","TA","intrepidtours","00046696","2019-02-27 08:21:08","refund"
"5c75d80a8d9166396db0c0e9",0,13003,"Final settlement","TA","intrepidtours","00046194","2019-02-27 07:21:30","confirmed"
"5c75111a8d9166396db0bfc4",-37,13003,"Update an order","TA","intrepidtours","00046697","2019-02-26 17:12:42","extra"
"5c7505338d9166396db0bf6f",111,13040,"Cancel order","TA","intrepidtours","00045726","2019-02-26 16:21:55","refund"
"5c749ffc9e44fa06907a8095",0,12929,"Final settlement","TA","intrepidtours","00046695","2019-02-26 09:10:04","confirmed"
"5c7499668d9166396db0bc79",0,12929,"Final settlement","TA","intrepidtours","00046199","2019-02-26 08:41:58","confirmed"
"5c73f2848d9166396db0bad5",-18012,12929,"Make a deposit","TA","intrepidtours","Adjust to correct balance - tour start using on 20-02-2019","2019-02-25 20:49:56","deposit"
"5c73c5688d9166396db0ba99",-124,30941,"Approved order 5c73c5568d9166396db0ba97","TA","intrepidtours","00046698","2019-02-25 17:37:28","withdraw"
"5c73c55b9e44fa06907a7e74",-74,31065,"Approved order 5c73c5199e44fa06907a7e72","TA","intrepidtours","00046697","2019-02-25 17:37:15","withdraw"
"5c73c5568d9166396db0ba98",0,31139,"Make an order for an approval","TA","intrepidtours","5c73c5568d9166396db0ba97","2019-02-25 17:37:10","tentative"
"5c73c5199e44fa06907a7e73",0,31139,"Make an order for an approval","TA","intrepidtours","5c73c5199e44fa06907a7e72","2019-02-25 17:36:09","tentative"
"5c73c5029e44fa06907a7e6f",-444,31139,"Approved order 5c73c4de8d9166396db0ba95","TA","intrepidtours","00046696","2019-02-25 17:35:46","withdraw"
"5c73c4de8d9166396db0ba96",0,31583,"Make an order for an approval","TA","intrepidtours","5c73c4de8d9166396db0ba95","2019-02-25 17:35:10","tentative"
"5c73c4a68d9166396db0ba92",-74,31583,"Approved order 5c73c45c9e44fa06907a7e6d","TA","intrepidtours","00046695","2019-02-25 17:34:14","withdraw"
"5c73c45c9e44fa06907a7e6e",0,31657,"Make an order for an approval","TA","intrepidtours","5c73c45c9e44fa06907a7e6d","2019-02-25 17:33:00","tentative"
"5c73be3b8d9166396db0ba6b",-434,31657,"Approved order 5c73bbd98d9166396db0ba4e","TA","intrepidtours","00046689","2019-02-25 17:06:51","withdraw"
"5c73be2c9e44fa06907a7e4d",-558,32091,"Approved order 5c73bc1c8d9166396db0ba56","TA","intrepidtours","00046688","2019-02-25 17:06:36","withdraw"
"5c73bc1c8d9166396db0ba57",0,32649,"Make an order for an approval","TA","intrepidtours","5c73bc1c8d9166396db0ba56","2019-02-25 16:57:48","tentative"
"5c73bbd98d9166396db0ba4f",0,32649,"Make an order for an approval","TA","intrepidtours","5c73bbd98d9166396db0ba4e","2019-02-25 16:56:41","tentative"
"5c73afc68d9166396db0ba03",0,32649,"Final settlement","TA","intrepidtours","00046192","2019-02-25 16:05:10","confirmed"
"5c73af1a9e44fa06907a7df0",-868,32649,"Approved order 5c734ecb9e44fa06907a7c1b","TA","intrepidtours","00046672","2019-02-25 16:02:18","withdraw"
"5c73ae8c9e44fa06907a7deb",-248,33517,"Approved order 5c734f448d9166396db0b82c","TA","intrepidtours","00046670","2019-02-25 15:59:56","withdraw"
"5c73ae379e44fa06907a7de6",-620,33765,"Approved order 5c735e199e44fa06907a7c82","TA","intrepidtours","00046669","2019-02-25 15:58:31","withdraw"
"5c73ae228d9166396db0b9eb",-259,34385,"Approved order 5c7395269e44fa06907a7d77","TA","intrepidtours","00046668","2019-02-25 15:58:10","withdraw"
"5c73adfd8d9166396db0b9e7",-372,34644,"Approved order 5c73ac838d9166396db0b9dc","TA","intrepidtours","00046667","2019-02-25 15:57:33","withdraw"
"5c73ade38d9166396db0b9e3",-744,35016,"Approved order 5c7395d98d9166396db0b98e","TA","intrepidtours","00046666","2019-02-25 15:57:07","withdraw"
"5c73ac838d9166396db0b9dd",0,35760,"Make an order for an approval","TA","intrepidtours","5c73ac838d9166396db0b9dc","2019-02-25 15:51:15","tentative"
"5c7395d98d9166396db0b98f",0,35760,"Make an order for an approval","TA","intrepidtours","5c7395d98d9166396db0b98e","2019-02-25 14:14:33","tentative"
"5c7395269e44fa06907a7d78",0,35760,"Make an order for an approval","TA","intrepidtours","5c7395269e44fa06907a7d77","2019-02-25 14:11:34","tentative"
"5c735e199e44fa06907a7c83",0,35760,"Make an order for an approval","TA","intrepidtours","5c735e199e44fa06907a7c82","2019-02-25 10:16:41","tentative"
"5c734f448d9166396db0b82d",0,35760,"Make an order for an approval","TA","intrepidtours","5c734f448d9166396db0b82c","2019-02-25 09:13:24","tentative"
"5c734ecb9e44fa06907a7c1c",0,35760,"Make an order for an approval","TA","intrepidtours","5c734ecb9e44fa06907a7c1b","2019-02-25 09:11:23","tentative"
"5c734c0e9e44fa06907a7c04",0,35760,"Final settlement","TA","intrepidtours","00046188","2019-02-25 08:59:42","confirmed"
"5c734bda8d9166396db0b657",0,35760,"Final settlement","TA","intrepidtours","00046187","2019-02-25 08:58:50","confirmed"
"5c734a718d9166396db0b64c",185,35760,"Update an order","TA","intrepidtours","00046187","2019-02-25 08:52:49","refund"
"5c73445d8d9166396db0b613",0,35575,"Final settlement","TA","intrepidtours","00046195","2019-02-25 08:26:53","confirmed"
"5c7220b88d9166396db0b324",0,35575,"Final settlement","TA","intrepidtours","00046200","2019-02-24 11:42:32","confirmed"
"5c71f9e08d9166396db0b29e",0,35575,"Final settlement","TA","intrepidtours","00045526","2019-02-24 08:56:48","confirmed"
"5c71f6ac9e44fa06907a772e",0,35575,"Final settlement","TA","intrepidtours","00046182","2019-02-24 08:43:08","confirmed"
"5c71f5cb9e44fa06907a7715",0,35575,"Final settlement","TA","intrepidtours","00046183","2019-02-24 08:39:23","confirmed"
"5c71ef238d9166396db0b212",0,35575,"Final settlement","TA","intrepidtours","00046184","2019-02-24 08:10:59","confirmed"
"5c71dbfe9e44fa06907a7596",0,35575,"Final settlement","TA","intrepidtours","00045704","2019-02-24 06:49:18","confirmed"
"5c71c5929e44fa06907a7572",0,35575,"Final settlement","TA","intrepidtours","00045524","2019-02-24 05:13:38","confirmed"
"5c70ce1a9e44fa06907a72c9",0,35575,"Final settlement","TA","intrepidtours","00045701","2019-02-23 11:37:46","confirmed"
"5c70a7839e44fa06907a7175",0,35575,"Final settlement","TA","intrepidtours","00046180","2019-02-23 08:53:07","confirmed"
"5c70a4168d9166396db0ace4",37,35575,"Update an order","TA","intrepidtours","00046180","2019-02-23 08:38:30","refund"
"5c707bd39e44fa06907a709e",0,35538,"Final settlement","TA","intrepidtours","00045806","2019-02-23 05:46:43","confirmed"
"5c6fd18d9e44fa06907a6fb6",-37,35538,"Update an order","TA","intrepidtours","00046187","2019-02-22 17:40:13","extra"
"5c6fc6dc9e44fa06907a6f8f",0,35575,"Final settlement","TA","intrepidtours","00045540","2019-02-22 16:54:36","confirmed"
"5c6fbc7f8d9166396db0aad6",-496,35575,"Approved order 5c6fb9a88d9166396db0aacc","TA","intrepidtours","00046200","2019-02-22 16:10:23","withdraw"
"5c6fbc599e44fa06907a6f4b",-496,36071,"Approved order 5c6fba509e44fa06907a6f37","TA","intrepidtours","00046199","2019-02-22 16:09:45","withdraw"
"5c6fba509e44fa06907a6f38",0,36567,"Make an order for an approval","TA","intrepidtours","5c6fba509e44fa06907a6f37","2019-02-22 16:01:04","tentative"
"5c6fb9a88d9166396db0aacd",0,36567,"Make an order for an approval","TA","intrepidtours","5c6fb9a88d9166396db0aacc","2019-02-22 15:58:16","tentative"
"5c6fb6bc8d9166396db0aac2",-744,36567,"Approved order 5c6f6edc9e44fa06907a6d33","TA","intrepidtours","00046195","2019-02-22 15:45:48","withdraw"
"5c6fb6b49e44fa06907a6f2a",-806,37311,"Approved order 5c6f6f228d9166396db0a727","TA","intrepidtours","00046194","2019-02-22 15:45:40","withdraw"
"5c6fb6859e44fa06907a6f27",-372,38117,"Approved order 5c6f6fbe8d9166396db0a72c","TA","intrepidtours","00046193","2019-02-22 15:44:53","withdraw"
"5c6fb66c9e44fa06907a6f24",-124,38489,"Approved order 5c6f81558d9166396db0a77f","TA","intrepidtours","00046192","2019-02-22 15:44:28","withdraw"
"5c6fb6078d9166396db0aabf",0,38613,"Final settlement","TA","intrepidtours","00045702","2019-02-22 15:42:47","confirmed"
"5c6fb0008d9166396db0aa95",-62,38613,"Approved order 5c6fa4039e44fa06907a6e9e","TA","intrepidtours","00046188","2019-02-22 15:17:04","withdraw"
"5c6fafec9e44fa06907a6f09",-296,38675,"Approved order 5c6fa3e08d9166396db0aa25","TA","intrepidtours","00046187","2019-02-22 15:16:44","withdraw"
"5c6faf088d9166396db0aa88",-74,38971,"Approved order 5c6fa37a9e44fa06907a6e95","TA","intrepidtours","00046184","2019-02-22 15:12:56","withdraw"
"5c6faefd9e44fa06907a6efe",-62,39045,"Approved order 5c6fa35b8d9166396db0aa23","TA","intrepidtours","00046183","2019-02-22 15:12:45","withdraw"
"5c6faee38d9166396db0aa82",-370,39107,"Approved order 5c6fa2999e44fa06907a6e83","TA","intrepidtours","00046182","2019-02-22 15:12:19","withdraw"
"5c6faeaa8d9166396db0aa7f",-444,39477,"Approved order 5c6fa22b9e44fa06907a6e7a","TA","intrepidtours","00046180","2019-02-22 15:11:22","withdraw"
"5c6fa4039e44fa06907a6e9f",0,39921,"Make an order for an approval","TA","intrepidtours","5c6fa4039e44fa06907a6e9e","2019-02-22 14:25:55","tentative"
"5c6fa3e08d9166396db0aa26",0,39921,"Make an order for an approval","TA","intrepidtours","5c6fa3e08d9166396db0aa25","2019-02-22 14:25:20","tentative"
"5c6fa37a9e44fa06907a6e96",0,39921,"Make an order for an approval","TA","intrepidtours","5c6fa37a9e44fa06907a6e95","2019-02-22 14:23:38","tentative"
"5c6fa35b8d9166396db0aa24",0,39921,"Make an order for an approval","TA","intrepidtours","5c6fa35b8d9166396db0aa23","2019-02-22 14:23:07","tentative"
"5c6fa2999e44fa06907a6e84",0,39921,"Make an order for an approval","TA","intrepidtours","5c6fa2999e44fa06907a6e83","2019-02-22 14:19:53","tentative"
"5c6fa22b9e44fa06907a6e7b",0,39921,"Make an order for an approval","TA","intrepidtours","5c6fa22b9e44fa06907a6e7a","2019-02-22 14:18:03","tentative"
"5c6f81558d9166396db0a780",0,39921,"Make an order for an approval","TA","intrepidtours","5c6f81558d9166396db0a77f","2019-02-22 11:57:57","tentative"
"5c6f6fbe8d9166396db0a72d",0,39921,"Make an order for an approval","TA","intrepidtours","5c6f6fbe8d9166396db0a72c","2019-02-22 10:42:54","tentative"
"5c6f6f228d9166396db0a728",0,39921,"Make an order for an approval","TA","intrepidtours","5c6f6f228d9166396db0a727","2019-02-22 10:40:18","tentative"
"5c6f6edc9e44fa06907a6d34",0,39921,"Make an order for an approval","TA","intrepidtours","5c6f6edc9e44fa06907a6d33","2019-02-22 10:39:08","tentative"
"5c6f500c8d9166396db0a62d",0,39921,"Final settlement","TA","intrepidtours","00045523","2019-02-22 08:27:40","confirmed"
"5c6f41869e44fa06907a6b23",0,39921,"Final settlement","TA","intrepidtours","00045796","2019-02-22 07:25:42","confirmed"
"5c6f409d9e44fa06907a6b1a",-50,39921,"Update an order","TA","intrepidtours","00045796","2019-02-22 07:21:49","extra"
"5c6f1fa58d9166396db0a4cc",0,39971,"Final settlement","TA","intrepidtours","00045703","2019-02-22 05:01:09","confirmed"
"5c6e2ebe9e44fa06907a67a4",0,39971,"Final settlement","TA","intrepidtours","00045527","2019-02-21 11:53:18","confirmed"
"5c6e0b048d9166396db0a0e5",-992,39971,"Approved order 5c6e0a809e44fa06907a66a0","TA","intrepidtours","00045806","2019-02-21 09:20:52","withdraw"
"5c6e0a809e44fa06907a66a1",0,40963,"Make an order for an approval","TA","intrepidtours","5c6e0a809e44fa06907a66a0","2019-02-21 09:18:40","tentative"
"5c6e00278d9166396db0a08e",0,40963,"Final settlement","TA","intrepidtours","00045522","2019-02-21 08:34:31","confirmed"
"5c6dfe899e44fa06907a661b",-74,40963,"Approved order 5c6dfb688d9166396db09f76","TA","intrepidtours","00045796","2019-02-21 08:27:37","withdraw"
"5c6dfb688d9166396db09f77",0,41037,"Make an order for an approval","TA","intrepidtours","5c6dfb688d9166396db09f76","2019-02-21 08:14:16","tentative"
"5c6dfb358d9166396db09f74",0,41037,"Final settlement","TA","intrepidtours","00045722","2019-02-21 08:13:25","confirmed"
"5c6dfaba8d9166396db09f69",0,41037,"Final settlement","TA","intrepidtours","00045724","2019-02-21 08:11:22","confirmed"
"5c6dfa798d9166396db09f64",124,41037,"Update an order","TA","intrepidtours","00045522","2019-02-21 08:10:17","refund"
"5c6dcf758d9166396db09e71",0,40913,"Final settlement","TA","intrepidtours","00045519","2019-02-21 05:06:45","confirmed"
"5c6dcf359e44fa06907a640c",37,40913,"Update an order","TA","intrepidtours","00045519","2019-02-21 05:05:41","refund"
"5c6d26688d9166396db09d7b",-111,40876,"Approved order 5c6d141c8d9166396db09d13","TA","intrepidtours","00045726","2019-02-20 17:05:28","withdraw"
"5c6d264c9e44fa06907a631d",-124,40987,"Approved order 5c6d13d29e44fa06907a62a1","TA","intrepidtours","00045724","2019-02-20 17:05:00","withdraw"
"5c6d26319e44fa06907a6315",-296,41111,"Approved order 5c6d13928d9166396db09d0f","TA","intrepidtours","00045722","2019-02-20 17:04:33","withdraw"
"5c6d14478d9166396db09d16",74,41407,"Final ticket change","TA","intrepidtours","00045538","2019-02-20 15:48:07","confirm_refund"
"5c6d141c8d9166396db09d14",0,41333,"Make an order for an approval","TA","intrepidtours","5c6d141c8d9166396db09d13","2019-02-20 15:47:24","tentative"
"5c6d13d29e44fa06907a62a2",0,41333,"Make an order for an approval","TA","intrepidtours","5c6d13d29e44fa06907a62a1","2019-02-20 15:46:10","tentative"
"5c6d13928d9166396db09d10",0,41333,"Make an order for an approval","TA","intrepidtours","5c6d13928d9166396db09d0f","2019-02-20 15:45:06","tentative"
"5c6d104f9e44fa06907a628e",-558,41333,"Approved order 5c6cb1de7424190b87d88aab","TA","intrepidtours","00045704","2019-02-20 15:31:11","withdraw"
"5c6d10399e44fa06907a628b",-682,41891,"Approved order 5c6d014f8d9166396db09ca6","TA","intrepidtours","00045703","2019-02-20 15:30:49","withdraw"
"5c6d10149e44fa06907a6288",-124,42573,"Approved order 5c6d0a689e44fa06907a6273","TA","intrepidtours","00045702","2019-02-20 15:30:12","withdraw"
"5c6d0ffa8d9166396db09d01",-124,42697,"Approved order 5c6d0a969e44fa06907a6275","TA","intrepidtours","00045701","2019-02-20 15:29:46","withdraw"
"5c6d0a969e44fa06907a6276",0,42821,"Make an order for an approval","TA","intrepidtours","5c6d0a969e44fa06907a6275","2019-02-20 15:06:46","tentative"
"5c6d0a689e44fa06907a6274",0,42821,"Make an order for an approval","TA","intrepidtours","5c6d0a689e44fa06907a6273","2019-02-20 15:06:00","tentative"
"5c6d014f8d9166396db09ca7",0,42821,"Make an order for an approval","TA","intrepidtours","5c6d014f8d9166396db09ca6","2019-02-20 14:27:11","tentative"
"5c6cb43e9e44fa06907a605b",0,42821,"Final settlement","TA","intrepidtours","00045521","2019-02-20 08:58:22","confirmed"
"5c6cb3b17424190b87d88ac4",0,42821,"Final settlement","TA","intrepidtours","00045520","2019-02-20 08:56:01","confirmed"
"5c6cb3639e44fa06907a6051",0,42821,"Final settlement","TA","intrepidtours","00045525","2019-02-20 08:54:43","confirmed"
"5c6cb1de7424190b87d88aac",0,42821,"Make an order for an approval","TA","intrepidtours","5c6cb1de7424190b87d88aab","2019-02-20 08:48:14","tentative"
"5c6cb0a09e44fa06907a6016",-186,42821,"Agent voucher expense","TA","intrepidtours","V00005334","2019-02-20 08:42:56","voucher_expense"
"5c6cb08e7424190b87d88a96",-992,43007,"Agent voucher expense","TA","intrepidtours","V00005333","2019-02-20 08:42:38","voucher_expense"
"5c6cb07d7424190b87d88a94",-222,43999,"Agent voucher expense","TA","intrepidtours","V00005332","2019-02-20 08:42:21","voucher_expense"
"5c6c82de9e44fa06907a5ede",37,44221,"Final ticket change","TA","intrepidtours","00045539","2019-02-20 05:27:42","confirm_refund"
"5c6be41f9e44fa06907a5e56",-1116,44184,"Approved order 5c6bc7887424190b87d888cf","TA","intrepidtours","00045540","2019-02-19 18:10:23","withdraw"
"5c6be4047424190b87d88906",-222,45300,"Approved order 5c6be1c19e44fa06907a5e48","TA","intrepidtours","00045539","2019-02-19 18:09:56","withdraw"
"5c6be3e87424190b87d88903",-222,45522,"Approved order 5c6be31b9e44fa06907a5e4e","TA","intrepidtours","00045538","2019-02-19 18:09:28","withdraw"
"5c6be31b9e44fa06907a5e4f",0,45744,"Make an order for an approval","TA","intrepidtours","5c6be31b9e44fa06907a5e4e","2019-02-19 18:06:03","tentative"
"5c6be1c19e44fa06907a5e49",0,45744,"Make an order for an approval","TA","intrepidtours","5c6be1c19e44fa06907a5e48","2019-02-19 18:00:17","tentative"
"5c6bc7887424190b87d888d0",0,45744,"Make an order for an approval","TA","intrepidtours","5c6bc7887424190b87d888cf","2019-02-19 16:08:24","tentative"
"5c6bc5799e44fa06907a5dfd",-558,45744,"Approved order 5c6bc3777424190b87d888c2","TA","intrepidtours","00045527","2019-02-19 15:59:37","withdraw"
"5c6bc5609e44fa06907a5dfa",-992,46302,"Approved order 5c6bc0579e44fa06907a5de9","TA","intrepidtours","00045526","2019-02-19 15:59:12","withdraw"
"5c6bc53d9e44fa06907a5df7",-620,47294,"Approved order 5c6bc0187424190b87d888b2","TA","intrepidtours","00045525","2019-02-19 15:58:37","withdraw"
"5c6bc50d7424190b87d888c8",-296,47914,"Approved order 5c6bb9bb9e44fa06907a5dc6","TA","intrepidtours","00045524","2019-02-19 15:57:49","withdraw"
"5c6bc48a9e44fa06907a5df4",-806,48210,"Approved order 5c6bbb237424190b87d88899","TA","intrepidtours","00045523","2019-02-19 15:55:38","withdraw"
"5c6bc4467424190b87d888c4",-682,49016,"Approved order 5c6bba719e44fa06907a5dcb","TA","intrepidtours","00045522","2019-02-19 15:54:30","withdraw"
"5c6bc3777424190b87d888c3",0,49698,"Make an order for an approval","TA","intrepidtours","5c6bc3777424190b87d888c2","2019-02-19 15:51:03","tentative"
"5c6bc1739e44fa06907a5dec",-248,49698,"Approved order 5c6bc1427424190b87d888bb","TA","intrepidtours","00045521","2019-02-19 15:42:27","withdraw"
"5c6bc1427424190b87d888bc",0,49946,"Make an order for an approval","TA","intrepidtours","5c6bc1427424190b87d888bb","2019-02-19 15:41:38","tentative"
"5c6bc1007424190b87d888b8",-37,49946,"Approved order 5c6bbfe47424190b87d888ae","TA","intrepidtours","00045520","2019-02-19 15:40:32","withdraw"
"5c6bc0c77424190b87d888b4",-370,49983,"Approved order 5c6bb8dc7424190b87d88889","TA","intrepidtours","00045519","2019-02-19 15:39:35","withdraw"
"5c6bc0579e44fa06907a5dea",0,50353,"Make an order for an approval","TA","intrepidtours","5c6bc0579e44fa06907a5de9","2019-02-19 15:37:43","tentative"
"5c6bc0187424190b87d888b3",0,50353,"Make an order for an approval","TA","intrepidtours","5c6bc0187424190b87d888b2","2019-02-19 15:36:40","tentative"
"5c6bbfe47424190b87d888af",0,50353,"Make an order for an approval","TA","intrepidtours","5c6bbfe47424190b87d888ae","2019-02-19 15:35:48","tentative"
"5c6bbb237424190b87d8889a",0,50353,"Make an order for an approval","TA","intrepidtours","5c6bbb237424190b87d88899","2019-02-19 15:15:31","tentative"
"5c6bba719e44fa06907a5dcc",0,50353,"Make an order for an approval","TA","intrepidtours","5c6bba719e44fa06907a5dcb","2019-02-19 15:12:33","tentative"
"5c6bb9bb9e44fa06907a5dc7",0,50353,"Make an order for an approval","TA","intrepidtours","5c6bb9bb9e44fa06907a5dc6","2019-02-19 15:09:31","tentative"
"5c6bb8dc7424190b87d8888a",0,50353,"Make an order for an approval","TA","intrepidtours","5c6bb8dc7424190b87d88889","2019-02-19 15:05:48","tentative"
"5c6a6fb47424190b87d88227",-992,50353,"Agent voucher expense","TA","intrepidtours","V00005308","2019-02-18 15:41:24","voucher_expense"
"5c6a6fa47424190b87d88225",-806,51345,"Update agent voucher expense","TA","intrepidtours","V00005307","2019-02-18 15:41:08","voucher_expense"
"5c6a6f999e44fa06907a5877",-992,52151,"Agent voucher expense","TA","intrepidtours","V00005307","2019-02-18 15:40:57","voucher_expense"
"5c6a6f8b7424190b87d88224",-148,53143,"Agent voucher expense","TA","intrepidtours","V00005306","2019-02-18 15:40:43","voucher_expense"
"5c6a6f807424190b87d88222",-74,53291,"Agent voucher expense","TA","intrepidtours","V00005305","2019-02-18 15:40:32","voucher_expense"
"5c69295b7424190b87d87d60",-372,53365,"Agent voucher expense","TA","intrepidtours","V00005279","2019-02-17 16:28:59","voucher_expense"
"5c69294b9e44fa06907a5401",-74,53737,"Agent voucher expense","TA","intrepidtours","V00005278","2019-02-17 16:28:43","voucher_expense"
"5c68c09a7424190b87d87bca",124,53811,"Update agent voucher expense","TA","intrepidtours","V00005248","2019-02-17 09:02:02","voucher_expense"
"5c68c0979e44fa06907a5275",-124,53687,"Agent voucher expense","TA","intrepidtours","V00005271","2019-02-17 09:01:59","voucher_expense"
"5c68c01d9e44fa06907a5265",124,53811,"Update agent voucher expense","TA","intrepidtours","V00005243","2019-02-17 08:59:57","voucher_expense"
"5c68c01a7424190b87d87bc2",186,53687,"Update agent voucher expense","TA","intrepidtours","V00005247","2019-02-17 08:59:54","voucher_expense"
"5c68c0179e44fa06907a5264",124,53501,"Update agent voucher expense","TA","intrepidtours","V00005246","2019-02-17 08:59:51","voucher_expense"
"5c68c0127424190b87d87bc1",186,53377,"Update agent voucher expense","TA","intrepidtours","V00005245","2019-02-17 08:59:46","voucher_expense"
"5c68c00f9e44fa06907a5263",186,53191,"Update agent voucher expense","TA","intrepidtours","V00005244","2019-02-17 08:59:43","voucher_expense"
"5c68c0087424190b87d87bc0",-13,53005,"Update agent voucher expense","TA","intrepidtours","V00005248","2019-02-17 08:59:36","voucher_expense"
"5c67c5297424190b87d878a9",-111,53018,"Agent voucher expense","TA","intrepidtours","V00005248","2019-02-16 15:09:13","voucher_expense"
"5c67c51a9e44fa06907a4f21",-186,53129,"Agent voucher expense","TA","intrepidtours","V00005247","2019-02-16 15:08:58","voucher_expense"
"5c67c50b7424190b87d878a7",-124,53315,"Update agent voucher expense","TA","intrepidtours","V00005244","2019-02-16 15:08:43","voucher_expense"
"5c67c5049e44fa06907a4f1f",-124,53439,"Agent voucher expense","TA","intrepidtours","V00005246","2019-02-16 15:08:36","voucher_expense"
"5c67c4f79e44fa06907a4f1d",-124,53563,"Update agent voucher expense","TA","intrepidtours","V00005245","2019-02-16 15:08:23","voucher_expense"
"5c67c4e87424190b87d878a6",-62,53687,"Agent voucher expense","TA","intrepidtours","V00005245","2019-02-16 15:08:08","voucher_expense"
"5c67c4db9e44fa06907a4f1c",-62,53749,"Agent voucher expense","TA","intrepidtours","V00005244","2019-02-16 15:07:55","voucher_expense"
"5c67c4b47424190b87d878a1",-124,53811,"Agent voucher expense","TA","intrepidtours","V00005243","2019-02-16 15:07:16","voucher_expense"
"5c6765359e44fa06907a4c2e",-992,53935,"Update agent voucher expense","TA","intrepidtours","V00005221","2019-02-16 08:19:49","voucher_expense"
"5c6677269e44fa06907a495b",-1178,54927,"Agent voucher expense","TA","intrepidtours","V00005223","2019-02-15 15:24:06","voucher_expense"
"5c6677189e44fa06907a4959",-868,56105,"Agent voucher expense","TA","intrepidtours","V00005222","2019-02-15 15:23:52","voucher_expense"
"5c6677039e44fa06907a4957",-744,56973,"Update agent voucher expense","TA","intrepidtours","V00005221","2019-02-15 15:23:31","voucher_expense"
"5c6676fa7424190b87d87317",-558,57717,"Agent voucher expense","TA","intrepidtours","V00005221","2019-02-15 15:23:22","voucher_expense"
"5c6676ec9e44fa06907a4956",-148,58275,"Agent voucher expense","TA","intrepidtours","V00005220","2019-02-15 15:23:08","voucher_expense"
"5c6676df7424190b87d87315",-592,58423,"Agent voucher expense","TA","intrepidtours","V00005219","2019-02-15 15:22:55","voucher_expense"
"5c661d0c9e44fa06907a4508",-558,59015,"Agent voucher expense","TA","intrepidtours","V00005194","2019-02-15 08:59:40","voucher_expense"
"5c661cf79e44fa06907a4506",-124,59573,"Update agent voucher expense","TA","intrepidtours","V00005189","2019-02-15 08:59:19","voucher_expense"
"5c661cec7424190b87d87018",-372,59697,"Agent voucher expense","TA","intrepidtours","V00005193","2019-02-15 08:59:08","voucher_expense"
"5c661cd69e44fa06907a4505",-444,60069,"Agent voucher expense","TA","intrepidtours","V00005192","2019-02-15 08:58:46","voucher_expense"
"5c661ccd7424190b87d87016",-592,60513,"Update agent voucher expense","TA","intrepidtours","V00005190","2019-02-15 08:58:37","voucher_expense"
"5c661cc19e44fa06907a4502",-444,61105,"Agent voucher expense","TA","intrepidtours","V00005191","2019-02-15 08:58:25","voucher_expense"
"5c661cad7424190b87d87013",-444,61549,"Agent voucher expense","TA","intrepidtours","V00005190","2019-02-15 08:58:05","voucher_expense"
"5c661c9c7424190b87d87011",-37,61993,"Agent voucher expense","TA","intrepidtours","V00005189","2019-02-15 08:57:48","voucher_expense"
"5c661c919e44fa06907a4500",-444,62030,"Agent voucher expense","TA","intrepidtours","V00005188","2019-02-15 08:57:37","voucher_expense"
"5c64d3049e44fa06907a3fbb",20000,62474,"Make a deposit","TA","intrepidtours","ANZ.312704(14/02/19)","2019-02-14 09:31:32","deposit"
"5c63e8797424190b87d86806",-444,42474,"Agent voucher expense","TA","intrepidtours","V00005179","2019-02-13 16:50:49","voucher_expense"
"5c63d4cf9e44fa06907a3c6e",-682,42918,"Agent voucher expense","TA","intrepidtours","V00005161","2019-02-13 15:26:55","voucher_expense"
"5c63d4c29e44fa06907a3c6c",-407,43600,"Agent voucher expense","TA","intrepidtours","V00005160","2019-02-13 15:26:42","voucher_expense"
"5c63d4997424190b87d86789",-444,44007,"Agent voucher expense","TA","intrepidtours","V00005159","2019-02-13 15:26:01","voucher_expense"
"5c63d48c9e44fa06907a3c69",-333,44451,"Agent voucher expense","TA","intrepidtours","V00005158","2019-02-13 15:25:48","voucher_expense"
"5c636c429e44fa06907a39af",-992,44784,"Agent voucher expense","TA","intrepidtours","V00005153","2019-02-13 08:00:50","voucher_expense"
"5c627e3f9e44fa06907a379e",-148,45776,"Agent voucher expense","TA","intrepidtours","V00005137","2019-02-12 15:05:19","voucher_expense"
"5c627e319e44fa06907a379c",-407,45924,"Agent voucher expense","TA","intrepidtours","V00005136","2019-02-12 15:05:05","voucher_expense"
"5c627e257424190b87d861af",-74,46331,"Agent voucher expense","TA","intrepidtours","V00005135","2019-02-12 15:04:53","voucher_expense"
"5c612ace7424190b87d85cee",-682,46405,"Update agent voucher expense","TA","intrepidtours","V00005116","2019-02-11 14:57:02","voucher_expense"
"5c612ac77424190b87d85ced",-62,47087,"Agent voucher expense","TA","intrepidtours","V00005116","2019-02-11 14:56:55","voucher_expense"
"5c612abb7424190b87d85ceb",-185,47149,"Agent voucher expense","TA","intrepidtours","V00005115","2019-02-11 14:56:43","voucher_expense"
"5c60d0467424190b87d85851",-248,47334,"Agent voucher expense","TA","intrepidtours","V00005105","2019-02-11 08:30:46","voucher_expense"
"5c5fdabf9e44fa06907a2bff",-496,47582,"Agent voucher expense","TA","intrepidtours","V00005091","2019-02-10 15:03:11","voucher_expense"
"5c5fdab07424190b87d855d4",-370,48078,"Agent voucher expense","TA","intrepidtours","V00005090","2019-02-10 15:02:56","voucher_expense"
"5c5f83ea9e44fa06907a2aa4",-444,48448,"Agent voucher expense","TA","intrepidtours","V00005066","2019-02-10 08:52:42","voucher_expense"
"5c5f83e09e44fa06907a2aa2",-620,48892,"Agent voucher expense","TA","intrepidtours","V00005065","2019-02-10 08:52:32","voucher_expense"
"5c5f83c87424190b87d85477",-124,49512,"Agent voucher expense","TA","intrepidtours","V00005064","2019-02-10 08:52:08","voucher_expense"
"5c5f83947424190b87d8546f",-930,49636,"Update agent voucher expense","TA","intrepidtours","V00005063","2019-02-10 08:51:16","voucher_expense"
"5c5f838a7424190b87d8546e",-124,50566,"Agent voucher expense","TA","intrepidtours","V00005063","2019-02-10 08:51:06","voucher_expense"
"5c5f837f9e44fa06907a2a9a",-444,50690,"Agent voucher expense","TA","intrepidtours","V00005062","2019-02-10 08:50:55","voucher_expense"
"5c5d3e829e44fa06907a2286",-558,51134,"Agent voucher expense","TA","intrepidtours","V00005042","2019-02-08 15:32:02","voucher_expense"
"5c5d3df77424190b87d84b9a",-1116,51692,"Agent voucher expense","TA","intrepidtours","V00005041","2019-02-08 15:29:43","voucher_expense"
"5c5d3da19e44fa06907a2280",-124,52808,"Agent voucher expense","TA","intrepidtours","V00005040","2019-02-08 15:28:17","voucher_expense"
"5c5d3d539e44fa06907a227a",-62,52932,"Update agent voucher expense","TA","intrepidtours","V00005039","2019-02-08 15:26:59","voucher_expense"
"5c5d3d4b7424190b87d84b97",-620,52994,"Agent voucher expense","TA","intrepidtours","V00005039","2019-02-08 15:26:51","voucher_expense"
"5c5d3a327424190b87d84b81",-259,53614,"Agent voucher expense","TA","intrepidtours","V00005038","2019-02-08 15:13:38","voucher_expense"
"5c5d3a1f7424190b87d84b79",-259,53873,"Agent voucher expense","TA","intrepidtours","V00005037","2019-02-08 15:13:19","voucher_expense"
"5c5ce3939e44fa06907a1c0e",-930,54132,"Update agent voucher expense","TA","intrepidtours","V00005013","2019-02-08 09:04:03","voucher_expense"
"5c5ce38b7424190b87d846aa",-744,55062,"Agent voucher expense","TA","intrepidtours","V00005013","2019-02-08 09:03:55","voucher_expense"
"5c5ce3807424190b87d845c7",-333,55806,"Agent voucher expense","TA","intrepidtours","V00005012","2019-02-08 09:03:44","voucher_expense"
"5c5ce36d7424190b87d845c5",-185,56139,"Agent voucher expense","TA","intrepidtours","V00005011","2019-02-08 09:03:25","voucher_expense"
"5c5b88699e44fa06907a1429",-444,56324,"Agent voucher expense","TA","intrepidtours","V00005003","2019-02-07 08:22:49","voucher_expense"
"5c5a973c9e44fa06907a10e6",-868,56768,"Agent voucher expense","TA","intrepidtours","V00004984","2019-02-06 15:13:48","voucher_expense"
"5c5a3f767424190b87d839f7",-124,57636,"Agent voucher expense","TA","intrepidtours","V00004963","2019-02-06 08:59:18","voucher_expense"
"5c5a3f697424190b87d839f5",-259,57760,"Agent voucher expense","TA","intrepidtours","V00004962","2019-02-06 08:59:05","voucher_expense"
"5c5a3f5a9e44fa06907a0f40",-37,58019,"Agent voucher expense","TA","intrepidtours","V00004961","2019-02-06 08:58:50","voucher_expense"
"5c59405c7424190b87d83720",20000,58056,"Make a deposit","TA","intrepidtours","ANZ.197247(04/02/19)","2019-02-05 14:50:52","deposit"
"5c58f2fe7424190b87d83538",-806,38056,"Agent voucher expense","TA","intrepidtours","V00004941","2019-02-05 09:20:46","voucher_expense"
"5c58f2db7424190b87d83536",-186,38862,"Agent voucher expense","TA","intrepidtours","V00004940","2019-02-05 09:20:11","voucher_expense"
"5c58f2caad439f37804d1a19",-62,39048,"Update agent voucher expense","TA","intrepidtours","V00004939","2019-02-05 09:19:54","voucher_expense"
"5c58f2c27424190b87d83534",-62,39110,"Agent voucher expense","TA","intrepidtours","V00004939","2019-02-05 09:19:46","voucher_expense"
"5c58f2b27424190b87d83532",-333,39172,"Update agent voucher expense","TA","intrepidtours","V00004938","2019-02-05 09:19:30","voucher_expense"
"5c58f2a5ad439f37804d1a18",-444,39505,"Agent voucher expense","TA","intrepidtours","V00004938","2019-02-05 09:19:17","voucher_expense"
"5c58f2997424190b87d83531",-148,39949,"Agent voucher expense","TA","intrepidtours","V00004937","2019-02-05 09:19:05","voucher_expense"
"5c56a3137424190b87d82dd9",-806,40097,"Agent voucher expense","TA","intrepidtours","V00004918","2019-02-03 15:15:15","voucher_expense"
"5c56a307ad439f37804d12e1",-62,40903,"Update agent voucher expense","TA","intrepidtours","V00004917","2019-02-03 15:15:03","voucher_expense"
"5c56a2ff7424190b87d82dd3",-407,40965,"Agent voucher expense","TA","intrepidtours","V00004917","2019-02-03 15:14:55","voucher_expense"
"5c563e83ad439f37804d10e5",-992,41372,"Agent voucher expense","TA","intrepidtours","V00004896","2019-02-03 08:06:11","voucher_expense"
"5c563e75ad439f37804d10e1",-444,42364,"Update agent voucher expense","TA","intrepidtours","V00004895","2019-02-03 08:05:57","voucher_expense"
"5c563e68ad439f37804d10de",-296,42808,"Update agent voucher expense","TA","intrepidtours","V00004895","2019-02-03 08:05:44","voucher_expense"
"5c563e4e7424190b87d82c01",-296,43104,"Agent voucher expense","TA","intrepidtours","V00004895","2019-02-03 08:05:18","voucher_expense"
"5c54ec33ad439f37804d0b36",-124,43400,"Agent voucher expense","TA","intrepidtours","V00004872","2019-02-02 08:02:43","voucher_expense"
"5c54ec267424190b87d82682",-930,43524,"Agent voucher expense","TA","intrepidtours","V00004871","2019-02-02 08:02:30","voucher_expense"
"5c54ec147424190b87d8267f",-74,44454,"Agent voucher expense","TA","intrepidtours","V00004870","2019-02-02 08:02:12","voucher_expense"
"5c52b211ad439f37804cfe31",-682,44528,"Update agent voucher expense","TA","intrepidtours","V00004848","2019-01-31 15:30:09","voucher_expense"
"5c52b2077424190b87d81d3f",-310,45210,"Agent voucher expense","TA","intrepidtours","V00004850","2019-01-31 15:29:59","voucher_expense"
"5c52b1f8ad439f37804cfe30",-372,45520,"Agent voucher expense","TA","intrepidtours","V00004849","2019-01-31 15:29:44","voucher_expense"
"5c52b1ecad439f37804cfe2e",-124,45892,"Update agent voucher expense","TA","intrepidtours","V00004848","2019-01-31 15:29:32","voucher_expense"
"5c52b1e57424190b87d81d3d",-62,46016,"Agent voucher expense","TA","intrepidtours","V00004848","2019-01-31 15:29:25","voucher_expense"
"5c52b1d3ad439f37804cfe29",-148,46078,"Update agent voucher expense","TA","intrepidtours","V00004847","2019-01-31 15:29:07","voucher_expense"
"5c52b1cb7424190b87d81d3b",-481,46226,"Agent voucher expense","TA","intrepidtours","V00004847","2019-01-31 15:28:59","voucher_expense"
"5c515b38ad439f37804cf8ca",-806,46707,"Agent voucher expense","TA","intrepidtours","V00004819","2019-01-30 15:07:20","voucher_expense"
"5c515b1fad439f37804cf8c4",-124,47513,"Agent voucher expense","TA","intrepidtours","V00004818","2019-01-30 15:06:55","voucher_expense"
"5c515b10ad439f37804cf8c2",-296,47637,"Agent voucher expense","TA","intrepidtours","V00004817","2019-01-30 15:06:40","voucher_expense"
"5c500e71ad439f37804cf4b1",10000,47933,"Make a deposit","TA","intrepidtours","ANZ 197245 (29/01/2019)","2019-01-29 15:27:29","deposit"
"5c500821ad439f37804cf469",-248,37933,"Agent voucher expense","TA","intrepidtours","V00004793","2019-01-29 15:00:33","voucher_expense"
"5c4fb4f9ad439f37804cf221",-992,38181,"Agent voucher expense","TA","intrepidtours","V00004776","2019-01-29 09:05:45","voucher_expense"
"5c4fb4e97424190b87d811df",-558,39173,"Agent voucher expense","TA","intrepidtours","V00004775","2019-01-29 09:05:29","voucher_expense"
"5c4fb4d3ad439f37804cf21e",-37,39731,"Agent voucher expense","TA","intrepidtours","V00004774","2019-01-29 09:05:07","voucher_expense"
"5c4d65277424190b87d80896",-248,39768,"Agent voucher expense","TA","intrepidtours","V00004745","2019-01-27 15:00:39","voucher_expense"
"5c4d65187424190b87d80894",-310,40016,"Agent voucher expense","TA","intrepidtours","V00004744","2019-01-27 15:00:24","voucher_expense"
"5c4d65067424190b87d80892",-296,40326,"Agent voucher expense","TA","intrepidtours","V00004743","2019-01-27 15:00:06","voucher_expense"
"5c4d64f7ad439f37804cea31",1550,40622,"Update agent voucher expense","TA","intrepidtours","V00004719","2019-01-27 14:59:51","voucher_expense"
"5c4d64f37424190b87d80890",333,39072,"Update agent voucher expense","TA","intrepidtours","V00004718","2019-01-27 14:59:47","voucher_expense"
"5c4d0e06ad439f37804ce8a9",-992,38739,"Update agent voucher expense","TA","intrepidtours","V00004719","2019-01-27 08:48:54","voucher_expense"
"5c4d0dfead439f37804ce8a6",-558,39731,"Agent voucher expense","TA","intrepidtours","V00004719","2019-01-27 08:48:46","voucher_expense"
"5c4d0decad439f37804ce8a2",-333,40289,"Agent voucher expense","TA","intrepidtours","V00004718","2019-01-27 08:48:28","voucher_expense"
"5c4bc9337424190b87d80147",-1116,40622,"Agent voucher expense","TA","intrepidtours","V00004714","2019-01-26 09:42:59","voucher_expense"
"5c4ac541ad439f37804ce030",-310,41738,"Agent voucher expense","TA","intrepidtours","V00004700","2019-01-25 15:13:53","voucher_expense"
"5c4ac5317424190b87d7fdcb",-620,42048,"Agent voucher expense","TA","intrepidtours","V00004699","2019-01-25 15:13:37","voucher_expense"
"5c4ac5277424190b87d7fdc9",-620,42668,"Agent voucher expense","TA","intrepidtours","V00004698","2019-01-25 15:13:27","voucher_expense"
"5c4ac508ad439f37804ce02d",-74,43288,"Agent voucher expense","TA","intrepidtours","V00004697","2019-01-25 15:12:56","voucher_expense"
"5c49768d7424190b87d7f88c",-868,43362,"Update agent voucher expense","TA","intrepidtours","V00004668","2019-01-24 15:25:49","voucher_expense"
"5c497686ad439f37804cda41",-186,44230,"Agent voucher expense","TA","intrepidtours","V00004668","2019-01-24 15:25:42","voucher_expense"
"5c4976777424190b87d7f887",-868,44416,"Agent voucher expense","TA","intrepidtours","V00004667","2019-01-24 15:25:27","voucher_expense"
"5c497669ad439f37804cda3f",-370,45284,"Agent voucher expense","TA","intrepidtours","V00004666","2019-01-24 15:25:13","voucher_expense"
"5c49765aad439f37804cda3d",-37,45654,"Agent voucher expense","TA","intrepidtours","V00004665","2019-01-24 15:24:58","voucher_expense"
"5c491c6dad439f37804cd7a9",-592,45691,"Update agent voucher expense","TA","intrepidtours","V00004639","2019-01-24 09:01:17","voucher_expense"
"5c4821bb7424190b87d7f2c6",-992,46283,"Agent voucher expense","TA","intrepidtours","V00004641","2019-01-23 15:11:39","voucher_expense"
"5c4821a9ad439f37804cd441",-62,47275,"Agent voucher expense","TA","intrepidtours","V00004640","2019-01-23 15:11:21","voucher_expense"
"5c4821817424190b87d7f2c0",-148,47337,"Agent voucher expense","TA","intrepidtours","V00004639","2019-01-23 15:10:41","voucher_expense"
"5c4821757424190b87d7f2be",-185,47485,"Agent voucher expense","TA","intrepidtours","V00004638","2019-01-23 15:10:29","voucher_expense"
"5c46e1c4c522ea47c3dc68fe",20000,47670,"Make a deposit","TA","intrepidtours","ANZ.197244(22/01/19)","2019-01-22 16:26:28","deposit"
"5c46de156b56503ab48186ea",-62,27670,"Agent voucher expense","TA","intrepidtours","V00004614","2019-01-22 16:10:45","voucher_expense"
"5c46de056b56503ab48186e8",-148,27732,"Agent voucher expense","TA","intrepidtours","V00004613","2019-01-22 16:10:29","voucher_expense"
"5c46ddf6c522ea47c3dc68db",-74,27880,"Agent voucher expense","TA","intrepidtours","V00004612","2019-01-22 16:10:14","voucher_expense"
"5c45803fc522ea47c3dc61ed",186,27954,"Update agent voucher expense","TA","intrepidtours","V00004591","2019-01-21 15:18:07","voucher_expense"
"5c45803bc522ea47c3dc61ec",744,27768,"Update agent voucher expense","TA","intrepidtours","V00004592","2019-01-21 15:18:03","voucher_expense"
"5c4580306b56503ab48180be",-744,27024,"Agent voucher expense","TA","intrepidtours","V00004592","2019-01-21 15:17:52","voucher_expense"
"5c45801d6b56503ab48180bc",-186,27768,"Agent voucher expense","TA","intrepidtours","V00004591","2019-01-21 15:17:33","voucher_expense"
"5c458003c522ea47c3dc61eb",-682,27954,"Agent voucher expense","TA","intrepidtours","V00004590","2019-01-21 15:17:07","voucher_expense"
"5c457ff8c522ea47c3dc61e9",-74,28636,"Agent voucher expense","TA","intrepidtours","V00004589","2019-01-21 15:16:56","voucher_expense"
"5c442b72c522ea47c3dc5d3f",-806,28710,"Agent voucher expense","TA","intrepidtours","V00004563","2019-01-20 15:04:02","voucher_expense"
"5c442b686b56503ab4817c0f",-296,29516,"Agent voucher expense","TA","intrepidtours","V00004562","2019-01-20 15:03:52","voucher_expense"
"5c442b5d6b56503ab4817c0c",-407,29812,"Agent voucher expense","TA","intrepidtours","V00004561","2019-01-20 15:03:41","voucher_expense"
"5c43d773c522ea47c3dc5bde",325,30219,"Update agent voucher expense","TA","intrepidtours","V00004531","2019-01-20 09:05:39","voucher_expense"
"5c43d7506b56503ab4817a7f",-186,29894,"Agent voucher expense","TA","intrepidtours","V00004532","2019-01-20 09:05:04","voucher_expense"
"5c43d73ac522ea47c3dc5bdd",-806,30080,"Agent voucher expense","TA","intrepidtours","V00004531","2019-01-20 09:04:42","voucher_expense"
"5c427ea8c522ea47c3dc574f",-1054,30886,"Agent voucher expense","TA","intrepidtours","V00004506","2019-01-19 08:34:32","voucher_expense"
"5c427e93c522ea47c3dc574d",-992,31940,"Agent voucher expense","TA","intrepidtours","V00004505","2019-01-19 08:34:11","voucher_expense"
"5c427e856b56503ab4817622",-558,32932,"Agent voucher expense","TA","intrepidtours","V00004504","2019-01-19 08:33:57","voucher_expense"
"5c427e746b56503ab481761f",-682,33490,"Update agent voucher expense","TA","intrepidtours","V00004503","2019-01-19 08:33:40","voucher_expense"
"5c427e5fc522ea47c3dc5746",-62,34172,"Agent voucher expense","TA","intrepidtours","V00004503","2019-01-19 08:33:19","voucher_expense"
"5c4039f36b56503ab4816d42",-310,34234,"Update agent voucher expense","TA","intrepidtours","V00004474","2019-01-17 15:16:51","voucher_expense"
"5c4039e96b56503ab4816d41",-806,34544,"Agent voucher expense","TA","intrepidtours","V00004474","2019-01-17 15:16:41","voucher_expense"
"5c4039df6b56503ab4816d3f",-372,35350,"Agent voucher expense","TA","intrepidtours","V00004473","2019-01-17 15:16:31","voucher_expense"
"5c4039cd6b56503ab4816d3d",-124,35722,"Agent voucher expense","TA","intrepidtours","V00004472","2019-01-17 15:16:13","voucher_expense"
"5c4039c0c522ea47c3dc4dc3",-148,35846,"Agent voucher expense","TA","intrepidtours","V00004471","2019-01-17 15:16:00","voucher_expense"
"5c4039b66b56503ab4816d3b",-370,35994,"Agent voucher expense","TA","intrepidtours","V00004470","2019-01-17 15:15:50","voucher_expense"
"5c3ee6b6c522ea47c3dc48e0",-62,36364,"Agent voucher expense","TA","intrepidtours","V00004448","2019-01-16 15:09:26","voucher_expense"
"5c3ee6a86b56503ab48167d9",-868,36426,"Agent voucher expense","TA","intrepidtours","V00004447","2019-01-16 15:09:12","voucher_expense"
"5c3ee69cc522ea47c3dc48de",-111,37294,"Agent voucher expense","TA","intrepidtours","V00004446","2019-01-16 15:09:00","voucher_expense"
"5c3ee6856b56503ab48167d7",-111,37405,"Agent voucher expense","TA","intrepidtours","V00004445","2019-01-16 15:08:37","voucher_expense"
"5c3ee663c522ea47c3dc48d6",-37,37516,"Agent voucher expense","TA","intrepidtours","V00004444","2019-01-16 15:08:03","voucher_expense"
"5c3e91446b56503ab481661a",20000,37553,"Make a deposit","TA","intrepidtours","ANZ 197234 (16/01/2019)","2019-01-16 09:04:52","deposit"
"5c3d928bc522ea47c3dc4445",-62,17553,"Agent voucher expense","TA","intrepidtours","V00004429","2019-01-15 14:58:03","voucher_expense"
"5c3d927b6b56503ab4816341",-682,17615,"Agent voucher expense","TA","intrepidtours","V00004428","2019-01-15 14:57:47","voucher_expense"
"5c3d926a6b56503ab481633c",-296,18297,"Agent voucher expense","TA","intrepidtours","V00004427","2019-01-15 14:57:30","voucher_expense"
"5c3d925bc522ea47c3dc4441",-481,18593,"Agent voucher expense","TA","intrepidtours","V00004426","2019-01-15 14:57:15","voucher_expense"
"5c3d3814c522ea47c3dc4146",-124,19074,"Agent voucher expense","TA","intrepidtours","V00004403","2019-01-15 08:32:04","voucher_expense"
"5c3d38066b56503ab4816145",-310,19198,"Agent voucher expense","TA","intrepidtours","V00004402","2019-01-15 08:31:50","voucher_expense"
"5c3d37f06b56503ab4816143",-930,19508,"Agent voucher expense","TA","intrepidtours","V00004401","2019-01-15 08:31:28","voucher_expense"
"5c3d37db6b56503ab481613f",-744,20438,"Agent voucher expense","TA","intrepidtours","V00004400","2019-01-15 08:31:07","voucher_expense"
"5c3d37d0c522ea47c3dc4144",-407,21182,"Agent voucher expense","TA","intrepidtours","V00004399","2019-01-15 08:30:56","voucher_expense"
"5c3be812c522ea47c3dc3a4e",-992,21589,"Agent voucher expense","TA","intrepidtours","V00004379","2019-01-14 08:38:26","voucher_expense"
"5c3be8016b56503ab4815ce6",-434,22581,"Agent voucher expense","TA","intrepidtours","V00004378","2019-01-14 08:38:09","voucher_expense"
"5c3be7f66b56503ab4815ce4",-248,23015,"Update agent voucher expense","TA","intrepidtours","V00004377","2019-01-14 08:37:58","voucher_expense"
"5c3be7f0c522ea47c3dc3a4a",-124,23263,"Agent voucher expense","TA","intrepidtours","V00004377","2019-01-14 08:37:52","voucher_expense"
"5c3be7e2c522ea47c3dc3a48",-74,23387,"Agent voucher expense","TA","intrepidtours","V00004376","2019-01-14 08:37:38","voucher_expense"
"5c399dcfc522ea47c3dc3446",-620,23461,"Agent voucher expense","TA","intrepidtours","V00004351","2019-01-12 14:57:03","voucher_expense"
"5c399db76b56503ab48156c3",-744,24081,"Agent voucher expense","TA","intrepidtours","V00004350","2019-01-12 14:56:39","voucher_expense"
"5c399da06b56503ab48156c0",-407,24825,"Agent voucher expense","TA","intrepidtours","V00004349","2019-01-12 14:56:16","voucher_expense"
"5c399d95c522ea47c3dc3444",-185,25232,"Agent voucher expense","TA","intrepidtours","V00004348","2019-01-12 14:56:05","voucher_expense"
"5c384954c522ea47c3dc301a",-682,25417,"Agent voucher expense","TA","intrepidtours","V00004330","2019-01-11 14:44:20","voucher_expense"
"5c3849466b56503ab48151d9",-434,26099,"Update agent voucher expense","TA","intrepidtours","V00004329","2019-01-11 14:44:06","voucher_expense"
"5c3849396b56503ab48151d8",-744,26533,"Agent voucher expense","TA","intrepidtours","V00004329","2019-01-11 14:43:53","voucher_expense"
"5c38492ec522ea47c3dc3018",-222,27277,"Agent voucher expense","TA","intrepidtours","V00004328","2019-01-11 14:43:42","voucher_expense"
"5c38491f6b56503ab48151d6",-74,27499,"Agent voucher expense","TA","intrepidtours","V00004327","2019-01-11 14:43:27","voucher_expense"
"5c37f1dc6b56503ab4814ec0",-1178,27573,"Agent voucher expense","TA","intrepidtours","V00004302","2019-01-11 08:31:08","voucher_expense"
"5c37f1ccbadf5328e092a5a9",-744,28751,"Agent voucher expense","TA","intrepidtours","V00004301","2019-01-11 08:30:52","voucher_expense"
"5c37f1bf6b56503ab4814ebe",-620,29495,"Agent voucher expense","TA","intrepidtours","V00004300","2019-01-11 08:30:39","voucher_expense"
"5c37f1a7badf5328e092a5a7",-124,30115,"Agent voucher expense","TA","intrepidtours","V00004299","2019-01-11 08:30:15","voucher_expense"
"5c37f1966b56503ab4814ebc",-148,30239,"Agent voucher expense","TA","intrepidtours","V00004298","2019-01-11 08:29:58","voucher_expense"
"5c37f1856b56503ab4814eba",-222,30387,"Agent voucher expense","TA","intrepidtours","V00004297","2019-01-11 08:29:41","voucher_expense"
"5c37f174badf5328e092a5a5",-148,30609,"Agent voucher expense","TA","intrepidtours","V00004296","2019-01-11 08:29:24","voucher_expense"
"5c37f15a6b56503ab4814eb8",-222,30757,"Agent voucher expense","TA","intrepidtours","V00004295","2019-01-11 08:28:58","voucher_expense"
"5c35a4ab48aad455162d0ff4",-744,30979,"Agent voucher expense","TA","intrepidtours","V00004272","2019-01-09 14:37:15","voucher_expense"
"5c35a49e48aad455162d0ff2",-806,31723,"Agent voucher expense","TA","intrepidtours","V00004271","2019-01-09 14:37:02","voucher_expense"
"5c35a48fd4fae27b108e69ea",-407,32529,"Agent voucher expense","TA","intrepidtours","V00004270","2019-01-09 14:36:47","voucher_expense"
"5c35a483d4fae27b108e69e6",-333,32936,"Agent voucher expense","TA","intrepidtours","V00004269","2019-01-09 14:36:35","voucher_expense"
"5c35a453d4fae27b108e69e2",74,33269,"Update agent voucher expense","TA","intrepidtours","V00004267","2019-01-09 14:35:47","voucher_expense"
"5c35a44048aad455162d0fef",-74,33195,"Agent voucher expense","TA","intrepidtours","V00004267","2019-01-09 14:35:28","voucher_expense"
"5c346cf4d4fae27b108e65f8",-620,33269,"Agent voucher expense","TA","intrepidtours","V00004247","2019-01-08 16:27:16","voucher_expense"
"5c346ce6d4fae27b108e65f2",-558,33889,"Agent voucher expense","TA","intrepidtours","V00004246","2019-01-08 16:27:02","voucher_expense"
"5c346cd548aad455162d0bd9",-62,34447,"Agent voucher expense","TA","intrepidtours","V00004245","2019-01-08 16:26:45","voucher_expense"
"5c346cc9d4fae27b108e65f0",-62,34509,"Agent voucher expense","TA","intrepidtours","V00004244","2019-01-08 16:26:33","voucher_expense"
"5c346ca8d4fae27b108e65ee",-74,34571,"Agent voucher expense","TA","intrepidtours","V00004243","2019-01-08 16:26:00","voucher_expense"
"5c346c9448aad455162d0bd7",-111,34645,"Agent voucher expense","TA","intrepidtours","V00004242","2019-01-08 16:25:40","voucher_expense"
"5c34099dd4fae27b108e61ba",-744,34756,"Update agent voucher expense","TA","intrepidtours","V00004222","2019-01-08 09:23:25","voucher_expense"
"5c34099348aad455162d0715",-930,35500,"Agent voucher expense","TA","intrepidtours","V00004222","2019-01-08 09:23:15","voucher_expense"
"5c340987d4fae27b108e61b9",-744,36430,"Agent voucher expense","TA","intrepidtours","V00004221","2019-01-08 09:23:03","voucher_expense"
"5c34097748aad455162d0712",-186,37174,"Agent voucher expense","TA","intrepidtours","V00004220","2019-01-08 09:22:47","voucher_expense"
"5c34096ed4fae27b108e61b7",-222,37360,"Agent voucher expense","TA","intrepidtours","V00004219","2019-01-08 09:22:38","voucher_expense"
"5c34095f48aad455162d0710",-74,37582,"Agent voucher expense","TA","intrepidtours","V00004218","2019-01-08 09:22:23","voucher_expense"
"5c32ac4348aad455162d02fd",-744,37656,"Update agent voucher expense","TA","intrepidtours","V00004191","2019-01-07 08:32:51","voucher_expense"
"5c32ac38d4fae27b108e5d93",-496,38400,"Agent voucher expense","TA","intrepidtours","V00004192","2019-01-07 08:32:40","voucher_expense"
"5c32ac1848aad455162d02fb",-434,38896,"Agent voucher expense","TA","intrepidtours","V00004191","2019-01-07 08:32:08","voucher_expense"
"5c32abff48aad455162d02f9",-186,39330,"Update agent voucher expense","TA","intrepidtours","V00004190","2019-01-07 08:31:43","voucher_expense"
"5c32abf0d4fae27b108e5d91",-62,39516,"Update agent voucher expense","TA","intrepidtours","V00004190","2019-01-07 08:31:28","voucher_expense"
"5c32abe8d4fae27b108e5d8c",-62,39578,"Agent voucher expense","TA","intrepidtours","V00004190","2019-01-07 08:31:20","voucher_expense"
"5c32abd8d4fae27b108e5d87",-296,39640,"Agent voucher expense","TA","intrepidtours","V00004189","2019-01-07 08:31:04","voucher_expense"
"5c32abc348aad455162d02f7",-222,39936,"Agent voucher expense","TA","intrepidtours","V00004188","2019-01-07 08:30:43","voucher_expense"
"5c32abb048aad455162d02f5",-333,40158,"Agent voucher expense","TA","intrepidtours","V00004187","2019-01-07 08:30:24","voucher_expense"
"5c305eacd4fae27b108e5831",-620,40491,"Update agent voucher expense","TA","intrepidtours","V00004156","2019-01-05 14:37:16","voucher_expense"
"5c305ea548aad455162cfe07",-434,41111,"Agent voucher expense","TA","intrepidtours","V00004156","2019-01-05 14:37:09","voucher_expense"
"5c305e9248aad455162cfe05",-186,41545,"Agent voucher expense","TA","intrepidtours","V00004155","2019-01-05 14:36:50","voucher_expense"
"5c305e7948aad455162cfe02",-124,41731,"Update agent voucher expense","TA","intrepidtours","V00004154","2019-01-05 14:36:25","voucher_expense"
"5c305e6fd4fae27b108e5830",-248,41855,"Agent voucher expense","TA","intrepidtours","V00004154","2019-01-05 14:36:15","voucher_expense"
"5c305e65d4fae27b108e582e",-333,42103,"Agent voucher expense","TA","intrepidtours","V00004153","2019-01-05 14:36:05","voucher_expense"
"5c305e5448aad455162cfe01",-222,42436,"Update agent voucher expense","TA","intrepidtours","V00004152","2019-01-05 14:35:48","voucher_expense"
"5c305e45d4fae27b108e582c",-148,42658,"Agent voucher expense","TA","intrepidtours","V00004152","2019-01-05 14:35:33","voucher_expense"
"5c305e3548aad455162cfe00",-185,42806,"Agent voucher expense","TA","intrepidtours","V00004151","2019-01-05 14:35:17","voucher_expense"
"5c300e4448aad455162cfb9c",-930,42991,"Agent voucher expense","TA","intrepidtours","V00004124","2019-01-05 08:54:12","voucher_expense"
"5c300e2148aad455162cfb98",-992,43921,"Agent voucher expense","TA","intrepidtours","V00004123","2019-01-05 08:53:37","voucher_expense"
"5c300e0bd4fae27b108e55d9",-806,44913,"Update agent voucher expense","TA","intrepidtours","V00004121","2019-01-05 08:53:15","voucher_expense"
"5c300e0348aad455162cfb92",-558,45719,"Agent voucher expense","TA","intrepidtours","V00004122","2019-01-05 08:53:07","voucher_expense"
"5c300df4d4fae27b108e55d8",-434,46277,"Agent voucher expense","TA","intrepidtours","V00004121","2019-01-05 08:52:52","voucher_expense"
"5c300dd948aad455162cfb90",-296,46711,"Agent voucher expense","TA","intrepidtours","V00004120","2019-01-05 08:52:25","voucher_expense"
"5c300dca48aad455162cfb8e",-148,47007,"Agent voucher expense","TA","intrepidtours","V00004119","2019-01-05 08:52:10","voucher_expense"
"5c2ec7ae48aad455162cf5c9",-806,47155,"Update agent voucher expense","TA","intrepidtours","V00004086","2019-01-04 09:40:46","voucher_expense"
"5c2ec7a748aad455162cf5c5",-372,47961,"Agent voucher expense","TA","intrepidtours","V00004086","2019-01-04 09:40:39","voucher_expense"
"5c2ec79ad4fae27b108e51da",-62,48333,"Agent voucher expense","TA","intrepidtours","V00004085","2019-01-04 09:40:26","voucher_expense"
"5c2ec78348aad455162cf5c2",-296,48395,"Agent voucher expense","TA","intrepidtours","V00004084","2019-01-04 09:40:03","voucher_expense"
"5c2ec776d4fae27b108e51d6",-259,48691,"Agent voucher expense","TA","intrepidtours","V00004083","2019-01-04 09:39:50","voucher_expense"
"5c2ec76448aad455162cf5c0",222,48950,"Update agent voucher expense","TA","intrepidtours","V00004047","2019-01-04 09:39:32","voucher_expense"
"5c2ec761d4fae27b108e51d4",868,48728,"Update agent voucher expense","TA","intrepidtours","V00004035","2019-01-04 09:39:29","voucher_expense"
"5c2ec75e48aad455162cf5bf",62,47860,"Update agent voucher expense","TA","intrepidtours","V00004034","2019-01-04 09:39:26","voucher_expense"
"5c2ec758d4fae27b108e51d3",370,47798,"Update agent voucher expense","TA","intrepidtours","V00004033","2019-01-04 09:39:20","voucher_expense"
"5c2ec75548aad455162cf5be",333,47428,"Update agent voucher expense","TA","intrepidtours","V00004032","2019-01-04 09:39:17","voucher_expense"
"5c2ec6ff48aad455162cf5bb",-682,47095,"Agent voucher expense","TA","intrepidtours","V00004081","2019-01-04 09:37:51","voucher_expense"
"5c2d721f24994b6de6faeb00",-222,47777,"Agent voucher expense","TA","intrepidtours","V00004047","2019-01-03 09:23:27","voucher_expense"
"5c2d6f7324994b6de6faeada",-744,47999,"Update agent voucher expense","TA","intrepidtours","V00004035","2019-01-03 09:12:03","voucher_expense"
"5c2d6f6a24994b6de6faead8",-124,48743,"Agent voucher expense","TA","intrepidtours","V00004035","2019-01-03 09:11:54","voucher_expense"
"5c2d6edf24994b6de6fae81f",-62,48867,"Agent voucher expense","TA","intrepidtours","V00004034","2019-01-03 09:09:35","voucher_expense"
"5c2d6e8025aba3704cd4e307",-222,48929,"Update agent voucher expense","TA","intrepidtours","V00004033","2019-01-03 09:08:00","voucher_expense"
"5c2d6e7225aba3704cd4e306",0,49151,"Update agent voucher expense","TA","intrepidtours","V00004033","2019-01-03 09:07:46","voucher_expense"
"5c2d6e3824994b6de6fae811",-148,49151,"Agent voucher expense","TA","intrepidtours","V00004033","2019-01-03 09:06:48","voucher_expense"
"5c2d6e2925aba3704cd4e303",-333,49299,"Agent voucher expense","TA","intrepidtours","V00004032","2019-01-03 09:06:33","voucher_expense"
"5c2c15f024994b6de6fae302",-310,49632,"Agent voucher expense","TA","intrepidtours","V00004007","2019-01-02 08:37:52","voucher_expense"
"5c2c156d24994b6de6fae2fd",-992,49942,"Agent voucher expense","TA","intrepidtours","V00004006","2019-01-02 08:35:41","voucher_expense"
"5c2c153324994b6de6fae2fb",-434,50934,"Update agent voucher expense","TA","intrepidtours","V00004005","2019-01-02 08:34:43","voucher_expense"
"5c2c152a24994b6de6fae2fa",-62,51368,"Agent voucher expense","TA","intrepidtours","V00004005","2019-01-02 08:34:34","voucher_expense"
"5c2c151924994b6de6fae2f8",-148,51430,"Agent voucher expense","TA","intrepidtours","V00004004","2019-01-02 08:34:17","voucher_expense"
"5c29dafe25aba3704cd4d4a3",-930,51578,"Agent voucher expense","TA","intrepidtours","V00003973","2018-12-31 16:01:50","voucher_expense"
"5c29daf224994b6de6fadd4e",-992,52508,"Update agent voucher expense","TA","intrepidtours","V00003972","2018-12-31 16:01:38","voucher_expense"
"5c29dae425aba3704cd4d4a1",-868,53500,"Agent voucher expense","TA","intrepidtours","V00003972","2018-12-31 16:01:24","voucher_expense"
"5c29dad725aba3704cd4d49d",-310,54368,"Agent voucher expense","TA","intrepidtours","V00003971","2018-12-31 16:01:11","voucher_expense"
"5c29dacb24994b6de6fadd4d",-592,54678,"Agent voucher expense","TA","intrepidtours","V00003970","2018-12-31 16:00:59","voucher_expense"
"5c29dabd25aba3704cd4d49b",-370,55270,"Agent voucher expense","TA","intrepidtours","V00003969","2018-12-31 16:00:45","voucher_expense"
"5c29daa424994b6de6fadd4b",-111,55640,"Agent voucher expense","TA","intrepidtours","V00003968","2018-12-31 16:00:20","voucher_expense"
"5c297e7e25aba3704cd4d233",-407,55751,"Agent voucher expense","TA","intrepidtours","V00003934","2018-12-31 09:27:10","voucher_expense"
"5c297e6c24994b6de6fad7f9",111,56158,"Update agent voucher expense","TA","intrepidtours","V00003929","2018-12-31 09:26:52","voucher_expense"
"5c297e5024994b6de6fad7f7",-930,56047,"Agent voucher expense","TA","intrepidtours","V00003933","2018-12-31 09:26:24","voucher_expense"
"5c297e3824994b6de6fad7f5",-992,56977,"Agent voucher expense","TA","intrepidtours","V00003932","2018-12-31 09:26:00","voucher_expense"
"5c297e1c25aba3704cd4d230",-248,57969,"Agent voucher expense","TA","intrepidtours","V00003931","2018-12-31 09:25:32","voucher_expense"
"5c297e0f25aba3704cd4d22e",-868,58217,"Agent voucher expense","TA","intrepidtours","V00003930","2018-12-31 09:25:19","voucher_expense"
"5c297e0624994b6de6fad7f2",-407,59085,"Agent voucher expense","TA","intrepidtours","V00003929","2018-12-31 09:25:10","voucher_expense"
"5c297d8825aba3704cd4d225",-370,59492,"Agent voucher expense","TA","intrepidtours","V00003928","2018-12-31 09:23:04","voucher_expense"
"5c28267524994b6de6fad3dc",-992,59862,"Agent voucher expense","TA","intrepidtours","V00003900","2018-12-30 08:59:17","voucher_expense"
"5c28266225aba3704cd4cded",-682,60854,"Agent voucher expense","TA","intrepidtours","V00003899","2018-12-30 08:58:58","voucher_expense"
"5c28265324994b6de6fad3da",-496,61536,"Agent voucher expense","TA","intrepidtours","V00003898","2018-12-30 08:58:43","voucher_expense"
"5c28264024994b6de6fad3d8",-310,62032,"Agent voucher expense","TA","intrepidtours","V00003897","2018-12-30 08:58:24","voucher_expense"
"5c28262724994b6de6fad3d6",-407,62342,"Agent voucher expense","TA","intrepidtours","V00003896","2018-12-30 08:57:59","voucher_expense"
"5c28261425aba3704cd4cdeb",-259,62749,"Agent voucher expense","TA","intrepidtours","V00003895","2018-12-30 08:57:40","voucher_expense"
"5c26d0f124994b6de6facbd2",-1178,63008,"Agent voucher expense","TA","intrepidtours","V00003850","2018-12-29 08:42:09","voucher_expense"
"5c26d0cd24994b6de6facbd0",-992,64186,"Agent voucher expense","TA","intrepidtours","V00003849","2018-12-29 08:41:33","voucher_expense"
"5c26d0b724994b6de6facbce",-248,65178,"Agent voucher expense","TA","intrepidtours","V00003848","2018-12-29 08:41:11","voucher_expense"
"5c26d0aa25aba3704cd4c473",-186,65426,"Agent voucher expense","TA","intrepidtours","V00003847","2018-12-29 08:40:58","voucher_expense"
"5c26d09724994b6de6facbcc",-370,65612,"Agent voucher expense","TA","intrepidtours","V00003846","2018-12-29 08:40:39","voucher_expense"
"5c26d08925aba3704cd4c46b",-148,65982,"Agent voucher expense","TA","intrepidtours","V00003845","2018-12-29 08:40:25","voucher_expense"
"5c24835a24994b6de6fac404",-930,66130,"Agent voucher expense","TA","intrepidtours","V00003813","2018-12-27 14:46:34","voucher_expense"
"5c24834a25aba3704cd4bc0b",-806,67060,"Agent voucher expense","TA","intrepidtours","V00003812","2018-12-27 14:46:18","voucher_expense"
"5c24830624994b6de6fac3fb",-248,67866,"Agent voucher expense","TA","intrepidtours","V00003811","2018-12-27 14:45:10","voucher_expense"
"5c2482f524994b6de6fac3f9",-370,68114,"Agent voucher expense","TA","intrepidtours","V00003810","2018-12-27 14:44:53","voucher_expense"
"5c2482e625aba3704cd4bc01",-434,68484,"Agent voucher expense","TA","intrepidtours","V00003809","2018-12-27 14:44:38","voucher_expense"
"5c2482da24994b6de6fac3f7",-222,68918,"Agent voucher expense","TA","intrepidtours","V00003808","2018-12-27 14:44:26","voucher_expense"
"5c2482ca25aba3704cd4bbff",-111,69140,"Agent voucher expense","TA","intrepidtours","V00003807","2018-12-27 14:44:10","voucher_expense"
"5c24309324994b6de6fac1dc",-868,69251,"Agent voucher expense","TA","intrepidtours","V00003780","2018-12-27 08:53:23","voucher_expense"
"5c24308625aba3704cd4ba19",-248,70119,"Update agent voucher expense","TA","intrepidtours","V00003779","2018-12-27 08:53:10","voucher_expense"
"5c24307d25aba3704cd4ba18",-186,70367,"Agent voucher expense","TA","intrepidtours","V00003779","2018-12-27 08:53:01","voucher_expense"
"5c24307324994b6de6fac1d6",-444,70553,"Agent voucher expense","TA","intrepidtours","V00003778","2018-12-27 08:52:51","voucher_expense"
"5c24306b25aba3704cd4ba16",-296,70997,"Agent voucher expense","TA","intrepidtours","V00003777","2018-12-27 08:52:43","voucher_expense"
"5c24305525aba3704cd4ba13",-185,71293,"Update agent voucher expense","TA","intrepidtours","V00003776","2018-12-27 08:52:21","voucher_expense"
"5c24304d24994b6de6fac1d1",-111,71478,"Agent voucher expense","TA","intrepidtours","V00003776","2018-12-27 08:52:13","voucher_expense"
"5c233c0225aba3704cd4b751",20000,71589,"Make a deposit","TA","intrepidtours","Cash","2018-12-26 15:29:54","deposit"
"5c22e2a125aba3704cd4b57f",-17360,51589,"Agent voucher expense","TA","intrepidtours","V00003764","2018-12-26 09:08:33","voucher_expense"
"5c22e28f24994b6de6fabcd1",-7326,68949,"Agent voucher expense","TA","intrepidtours","V00003763","2018-12-26 09:08:15","voucher_expense"
"5c21e6e625aba3704cd4b38a",-682,76275,"Agent voucher expense","TA","intrepidtours","V00003739","2018-12-25 15:14:30","voucher_expense"
"5c21e6dc24994b6de6faba94",-620,76957,"Agent voucher expense","TA","intrepidtours","V00003738","2018-12-25 15:14:20","voucher_expense"
"5c21af9324994b6de6fab93a",20000,77577,"Make a deposit","TA","intrepidtours","ANZ Royal Bank""312674""(25/12/18)","2018-12-25 11:18:27","deposit"
"5c218eb025aba3704cd4b0c7",-496,57577,"Agent voucher expense","TA","intrepidtours","V00003713","2018-12-25 08:58:08","voucher_expense"
"5c218e7e24994b6de6fab6d3",-620,58073,"Agent voucher expense","TA","intrepidtours","V00003712","2018-12-25 08:57:18","voucher_expense"
"5c218e6824994b6de6fab6d1",-620,58693,"Agent voucher expense","TA","intrepidtours","V00003711","2018-12-25 08:56:56","voucher_expense"
"5c218e5d25aba3704cd4b0c5",-222,59313,"Agent voucher expense","TA","intrepidtours","V00003710","2018-12-25 08:56:45","voucher_expense"
"5c218e4825aba3704cd4b0c2",-259,59535,"Agent voucher expense","TA","intrepidtours","V00003709","2018-12-25 08:56:24","voucher_expense"
"5c218e3b24994b6de6fab6cd",-222,59794,"Agent voucher expense","TA","intrepidtours","V00003708","2018-12-25 08:56:11","voucher_expense"
"5c1f3eb4bcc94353d2999d89",-620,60016,"Agent voucher expense","TA","intrepidtours","V00003674","2018-12-23 14:52:20","voucher_expense"
"5c1f3ea7ebae59488f7d6cf3",-124,60636,"Update agent voucher expense","TA","intrepidtours","V00003673","2018-12-23 14:52:07","voucher_expense"
"5c1f3ea0ebae59488f7d6cf2",-62,60760,"Agent voucher expense","TA","intrepidtours","V00003673","2018-12-23 14:52:00","voucher_expense"
"5c1f3e8eebae59488f7d6cee",-407,60822,"Agent voucher expense","TA","intrepidtours","V00003672","2018-12-23 14:51:42","voucher_expense"
"5c1f3e78bcc94353d2999d87",-185,61229,"Agent voucher expense","TA","intrepidtours","V00003671","2018-12-23 14:51:20","voucher_expense"
"5c1ded1cebae59488f7d6969",-496,61414,"Agent voucher expense","TA","intrepidtours","V00003648","2018-12-22 14:51:56","voucher_expense"
"5c1ded0fbcc94353d29999e4",-407,61910,"Agent voucher expense","TA","intrepidtours","V00003647","2018-12-22 14:51:43","voucher_expense"
"5c1ded01ebae59488f7d6967",-185,62317,"Agent voucher expense","TA","intrepidtours","V00003646","2018-12-22 14:51:29","voucher_expense"
"5c1ca15debae59488f7d652e",-248,62502,"Agent voucher expense","TA","intrepidtours","V00003623","2018-12-21 15:16:29","voucher_expense"
"5c1ca148bcc94353d299959a",-333,62750,"Update agent voucher expense","TA","intrepidtours","V00003622","2018-12-21 15:16:08","voucher_expense"
"5c1ca13fbcc94353d2999599",-259,63083,"Agent voucher expense","TA","intrepidtours","V00003622","2018-12-21 15:15:59","voucher_expense"
"5c1ca133ebae59488f7d652b",-37,63342,"Agent voucher expense","TA","intrepidtours","V00003621","2018-12-21 15:15:47","voucher_expense"
"5c1c4983ebae59488f7d62f9",-496,63379,"Update agent voucher expense","TA","intrepidtours","V00003600","2018-12-21 09:01:39","voucher_expense"
"5c1c497bbcc94353d2999388",-434,63875,"Agent voucher expense","TA","intrepidtours","V00003601","2018-12-21 09:01:31","voucher_expense"
"5c1c496fbcc94353d2999384",-248,64309,"Agent voucher expense","TA","intrepidtours","V00003600","2018-12-21 09:01:19","voucher_expense"
"5c1c4961bcc94353d2999382",-592,64557,"Agent voucher expense","TA","intrepidtours","V00003599","2018-12-21 09:01:05","voucher_expense"
"5c1c494cebae59488f7d62f8",-740,65149,"Agent voucher expense","TA","intrepidtours","V00003598","2018-12-21 09:00:44","voucher_expense"
"5c1c4941bcc94353d2999380",-370,65889,"Agent voucher expense","TA","intrepidtours","V00003597","2018-12-21 09:00:33","voucher_expense"
"5c1c4930bcc94353d299937e",-148,66259,"Agent voucher expense","TA","intrepidtours","V00003596","2018-12-21 09:00:16","voucher_expense"
"5c1b1666ebae59488f7d5f7f",20000,66407,"Make a deposit","TA","intrepidtours","ANZ (197231)19/12/2018","2018-12-20 11:11:18","deposit"
"5c1aee3debae59488f7d5e6f",-186,46407,"Update agent voucher expense","TA","intrepidtours","V00003571","2018-12-20 08:19:57","voucher_expense"
"5c19f5c9ebae59488f7d5b6e",-930,46593,"Agent voucher expense","TA","intrepidtours","V00003572","2018-12-19 14:39:53","voucher_expense"
"5c19f5bdebae59488f7d5b6c",-496,47523,"Agent voucher expense","TA","intrepidtours","V00003571","2018-12-19 14:39:41","voucher_expense"
"5c19f5afbcc94353d2998c3b",-74,48019,"Agent voucher expense","TA","intrepidtours","V00003570","2018-12-19 14:39:27","voucher_expense"
"5c19f597bcc94353d2998c37",-37,48093,"Agent voucher expense","TA","intrepidtours","V00003569","2018-12-19 14:39:03","voucher_expense"
"5c18a57febae59488f7d580f",-434,48130,"Agent voucher expense","TA","intrepidtours","V00003545","2018-12-18 14:45:03","voucher_expense"
"5c18a572bcc94353d29988ac",-310,48564,"Agent voucher expense","TA","intrepidtours","V00003544","2018-12-18 14:44:50","voucher_expense"
"5c18a565ebae59488f7d580d",-124,48874,"Agent voucher expense","TA","intrepidtours","V00003543","2018-12-18 14:44:37","voucher_expense"
"5c18a55bbcc94353d29988a9",-124,48998,"Agent voucher expense","TA","intrepidtours","V00003542","2018-12-18 14:44:27","voucher_expense"
"5c18a54aebae59488f7d5809",-148,49122,"Agent voucher expense","TA","intrepidtours","V00003541","2018-12-18 14:44:10","voucher_expense"
"5c186ec2bcc94353d2998746",-15996,49270,"Agent voucher expense","TA","intrepidtours","V00003518","2018-12-18 10:51:30","voucher_expense"
"5c186e89bcc94353d2998744",-3589,65266,"Agent voucher expense","TA","intrepidtours","V00003517","2018-12-18 10:50:33","voucher_expense"
"5c186df9bcc94353d2998742",-12710,68855,"Agent voucher expense","TA","intrepidtours","V00003516","2018-12-18 10:48:09","voucher_expense"
"5c186d3cebae59488f7d56dd",-3663,81565,"Agent voucher expense","TA","intrepidtours","V00003515","2018-12-18 10:45:00","voucher_expense"
"5c175592bcc94353d29983d5",-248,85228,"Agent voucher expense","TA","intrepidtours","V00003480","2018-12-17 14:51:46","voucher_expense"
"5c175579bcc94353d29983d2",-62,85476,"Agent voucher expense","TA","intrepidtours","V00003479","2018-12-17 14:51:21","voucher_expense"
"5c17556abcc94353d29983d0",-518,85538,"Agent voucher expense","TA","intrepidtours","V00003478","2018-12-17 14:51:06","voucher_expense"
"5c175558bcc94353d29983cb",-37,86056,"Agent voucher expense","TA","intrepidtours","V00003477","2018-12-17 14:50:48","voucher_expense"
"5c1754c6ebae59488f7d52a7",-37,86093,"Agent voucher expense","TA","intrepidtours","V00003476","2018-12-17 14:48:22","voucher_expense"
"5c16ffd1ebae59488f7d5142",-620,86130,"Update agent voucher expense","TA","intrepidtours","V00003458","2018-12-17 08:45:53","voucher_expense"
"5c16ffcabcc94353d2998224",-62,86750,"Agent voucher expense","TA","intrepidtours","V00003459","2018-12-17 08:45:46","voucher_expense"
"5c16ffb8ebae59488f7d5140",-62,86812,"Agent voucher expense","TA","intrepidtours","V00003458","2018-12-17 08:45:28","voucher_expense"
"5c16ffabbcc94353d2998222",-222,86874,"Agent voucher expense","TA","intrepidtours","V00003457","2018-12-17 08:45:15","voucher_expense"
"5c16ffa1bcc94353d2998220",-74,87096,"Agent voucher expense","TA","intrepidtours","V00003456","2018-12-17 08:45:05","voucher_expense"
"5c14c5f4bcc94353d2997cd3",-620,87170,"Agent voucher expense","TA","intrepidtours","V00003442","2018-12-15 16:14:28","voucher_expense"
"5c14c5e7ebae59488f7d4baf",-372,87790,"Agent voucher expense","TA","intrepidtours","V00003441","2018-12-15 16:14:15","voucher_expense"
"5c14c5d0ebae59488f7d4bad",-62,88162,"Agent voucher expense","TA","intrepidtours","V00003440","2018-12-15 16:13:52","voucher_expense"
"5c13619ccb943469dcd1af7d",-620,88224,"Agent voucher expense","TA","intrepidtours","V00003429","2018-12-14 14:54:04","voucher_expense"
"5c13619025b47c731f3fdfdb",-259,88844,"Agent voucher expense","TA","intrepidtours","V00003428","2018-12-14 14:53:52","voucher_expense"
"5c120cb0cb943469dcd1aaeb",-434,89103,"Agent voucher expense","TA","intrepidtours","V00003414","2018-12-13 14:39:28","voucher_expense"
"5c120c9ccb943469dcd1aae8",-222,89537,"Agent voucher expense","TA","intrepidtours","V00003413","2018-12-13 14:39:08","voucher_expense"
"5c120c8fcb943469dcd1aae6",-62,89759,"Agent voucher expense","TA","intrepidtours","V00003412","2018-12-13 14:38:55","voucher_expense"
"5c120c8325b47c731f3fdbcc",-370,89821,"Agent voucher expense","TA","intrepidtours","V00003411","2018-12-13 14:38:43","voucher_expense"
"5c120c67cb943469dcd1aae4",-259,90191,"Agent voucher expense","TA","intrepidtours","V00003410","2018-12-13 14:38:15","voucher_expense"
"5c10bec125b47c731f3fd620",-124,90450,"Agent voucher expense","TA","intrepidtours","V00003397","2018-12-12 14:54:41","voucher_expense"
"5c10beb9cb943469dcd1a69b",-370,90574,"Agent voucher expense","TA","intrepidtours","V00003396","2018-12-12 14:54:33","voucher_expense"
"5c10beadcb943469dcd1a698",-111,90944,"Agent voucher expense","TA","intrepidtours","V00003395","2018-12-12 14:54:21","voucher_expense"
"5c0f673e25b47c731f3fd070",-372,91055,"Agent voucher expense","TA","intrepidtours","V00003371","2018-12-11 14:29:02","voucher_expense"
"5c0f672725b47c731f3fd06e",-148,91427,"Agent voucher expense","TA","intrepidtours","V00003370","2018-12-11 14:28:39","voucher_expense"
"5c0e1c2fcb943469dcd19df7",-806,91575,"Agent voucher expense","TA","intrepidtours","V00003352","2018-12-10 14:56:31","voucher_expense"
"5c0e1c2425b47c731f3fcd16",-62,92381,"Agent voucher expense","TA","intrepidtours","V00003351","2018-12-10 14:56:20","voucher_expense"
"5c0e1c19cb943469dcd19df5",-74,92443,"Agent voucher expense","TA","intrepidtours","V00003350","2018-12-10 14:56:09","voucher_expense"
"5c0ce86225b47c731f3fca51",-444,92517,"Agent voucher expense","TA","intrepidtours","V00003332","2018-12-09 17:03:14","voucher_expense"
"5c0ce84e25b47c731f3fca4f",-407,92961,"Agent voucher expense","TA","intrepidtours","V00003331","2018-12-09 17:02:54","voucher_expense"
"5c0ce82f25b47c731f3fca4d",-148,93368,"Agent voucher expense","TA","intrepidtours","V00003330","2018-12-09 17:02:23","voucher_expense"
"5c0c703025b47c731f3fc857",-434,93516,"Agent voucher expense","TA","intrepidtours","V00003313","2018-12-09 08:30:24","voucher_expense"
"5c0c7026cb943469dcd1994f",-74,93950,"Agent voucher expense","TA","intrepidtours","V00003312","2018-12-09 08:30:14","voucher_expense"
"5c0b1c6025b47c731f3fc410",-992,94024,"Agent voucher expense","TA","intrepidtours","V00003288","2018-12-08 08:20:32","voucher_expense"
"5c0b1c50cb943469dcd19511",-407,95016,"Agent voucher expense","TA","intrepidtours","V00003287","2018-12-08 08:20:16","voucher_expense"
"5c0b1c3ecb943469dcd1950f",-74,95423,"Agent voucher expense","TA","intrepidtours","V00003286","2018-12-08 08:19:58","voucher_expense"
"5c09d083cb943469dcd19090",-682,95497,"Agent voucher expense","TA","intrepidtours","V00003280","2018-12-07 08:44:35","voucher_expense"
"5c09cee9cb943469dcd19072",-744,96179,"Agent voucher expense","TA","intrepidtours","V00003263","2018-12-07 08:37:45","voucher_expense"
"5c09ced7cb943469dcd19068",-444,96923,"Update agent voucher expense","TA","intrepidtours","V00003260","2018-12-07 08:37:27","voucher_expense"
"5c09cececb943469dcd19067",-185,97367,"Agent voucher expense","TA","intrepidtours","V00003262","2018-12-07 08:37:18","voucher_expense"
"5c09cec4cb943469dcd19065",-74,97552,"Agent voucher expense","TA","intrepidtours","V00003261","2018-12-07 08:37:08","voucher_expense"
"5c09ceb825b47c731f3fbf07",-74,97626,"Agent voucher expense","TA","intrepidtours","V00003260","2018-12-07 08:36:56","voucher_expense"
"5c09ceadcb943469dcd19063",-37,97700,"Agent voucher expense","TA","intrepidtours","V00003259","2018-12-07 08:36:45","voucher_expense"
"5c09ce9d25b47c731f3fbf05",-682,97737,"Agent voucher expense","TA","intrepidtours","V00003258","2018-12-07 08:36:29","voucher_expense"
"5c079ceccb943469dcd18993",-372,98419,"Agent voucher expense","TA","intrepidtours","V00003232","2018-12-05 16:39:56","voucher_expense"
"5c079cdf25b47c731f3fb7cd",-124,98791,"Agent voucher expense","TA","intrepidtours","V00003231","2018-12-05 16:39:43","voucher_expense"
"5c079ccacb943469dcd18990",-370,98915,"Agent voucher expense","TA","intrepidtours","V00003230","2018-12-05 16:39:22","voucher_expense"
"5c079cae25b47c731f3fb7c9",-259,99285,"Agent voucher expense","TA","intrepidtours","V00003229","2018-12-05 16:38:54","voucher_expense"
"5c072bc5cb943469dcd1879b",-124,99544,"Agent voucher expense","TA","intrepidtours","V00003205","2018-12-05 08:37:09","voucher_expense"
"5c072bb225b47c731f3fb51e",-310,99668,"Agent voucher expense","TA","intrepidtours","V00003204","2018-12-05 08:36:50","voucher_expense"
"5c072ba225b47c731f3fb51c",-124,99978,"Agent voucher expense","TA","intrepidtours","V00003203","2018-12-05 08:36:34","voucher_expense"
"5c072b93cb943469dcd18797",-370,100102,"Update agent voucher expense","TA","intrepidtours","V00003202","2018-12-05 08:36:19","voucher_expense"
"5c072b8925b47c731f3fb518",-296,100472,"Update agent voucher expense","TA","intrepidtours","V00003202","2018-12-05 08:36:09","voucher_expense"
"5c072b7925b47c731f3fb515",-222,100768,"Agent voucher expense","TA","intrepidtours","V00003202","2018-12-05 08:35:53","voucher_expense"
"5c072b6bcb943469dcd18792",-37,100990,"Agent voucher expense","TA","intrepidtours","V00003201","2018-12-05 08:35:39","voucher_expense"
"5c05dbe3cb943469dcd182dd",-682,101027,"Agent voucher expense","TA","intrepidtours","V00003175","2018-12-04 08:44:03","voucher_expense"
"5c05dbd825b47c731f3fad62",-434,101709,"Agent voucher expense","TA","intrepidtours","V00003174","2018-12-04 08:43:52","voucher_expense"
"5c05dbcb25b47c731f3fad60",-434,102143,"Agent voucher expense","TA","intrepidtours","V00003173","2018-12-04 08:43:39","voucher_expense"
"5c05dbbecb943469dcd182da",-62,102577,"Update agent voucher expense","TA","intrepidtours","V00003172","2018-12-04 08:43:26","voucher_expense"
"5c05dbb325b47c731f3fad5e",-62,102639,"Agent voucher expense","TA","intrepidtours","V00003172","2018-12-04 08:43:15","voucher_expense"
"5c05dba6cb943469dcd182d9",-74,102701,"Agent voucher expense","TA","intrepidtours","V00003171","2018-12-04 08:43:02","voucher_expense"
"5c05db9a25b47c731f3fad5c",-37,102775,"Agent voucher expense","TA","intrepidtours","V00003170","2018-12-04 08:42:50","voucher_expense"
"5c04a76591e6de138e184825",30000,102812,"Make a deposit","TA","intrepidtours","ANZ 197216 (03/12/18)","2018-12-03 10:47:49","deposit"
"5c048f9d0640335131f7cfa7",-434,72812,"Agent voucher expense","TA","intrepidtours","V00003142","2018-12-03 09:06:21","voucher_expense"
"5c048f880640335131f7cfa5",-310,73246,"Agent voucher expense","TA","intrepidtours","V00003141","2018-12-03 09:06:00","voucher_expense"
"5c048f7991e6de138e1845ee",-124,73556,"Agent voucher expense","TA","intrepidtours","V00003140","2018-12-03 09:05:45","voucher_expense"
"5c048f6b0640335131f7cfa3",-185,73680,"Agent voucher expense","TA","intrepidtours","V00003139","2018-12-03 09:05:31","voucher_expense"
"5c048f5b91e6de138e1845ec",-370,73865,"Agent voucher expense","TA","intrepidtours","V00003138","2018-12-03 09:05:15","voucher_expense"
"5c048f2c0640335131f7cf9d",-222,74235,"Agent voucher expense","TA","intrepidtours","V00003137","2018-12-03 09:04:28","voucher_expense"
"5c033ac191e6de138e184329",-124,74457,"Agent voucher expense","TA","intrepidtours","V00003117","2018-12-02 08:52:01","voucher_expense"
"5c033ab40640335131f7ccd1",-992,74581,"Agent voucher expense","TA","intrepidtours","V00003116","2018-12-02 08:51:48","voucher_expense"
"5c033a8e91e6de138e184326",-558,75573,"Agent voucher expense","TA","intrepidtours","V00003115","2018-12-02 08:51:10","voucher_expense"
"5c033a7e91e6de138e184324",-496,76131,"Agent voucher expense","TA","intrepidtours","V00003114","2018-12-02 08:50:54","voucher_expense"
"5c033a7191e6de138e184321",-185,76627,"Agent voucher expense","TA","intrepidtours","V00003113","2018-12-02 08:50:41","voucher_expense"
"5c01e2e50640335131f7c8a6",-868,76812,"Update agent voucher expense","TA","intrepidtours","V00003085","2018-12-01 08:24:53","voucher_expense"
"5c01e2d991e6de138e183f0e",-434,77680,"Agent voucher expense","TA","intrepidtours","V00003085","2018-12-01 08:24:41","voucher_expense"
"5c01e2cc0640335131f7c8a5",-370,78114,"Agent voucher expense","TA","intrepidtours","V00003084","2018-12-01 08:24:28","voucher_expense"
"5c0098e80640335131f7bff2",-481,78484,"Update agent voucher expense","TA","intrepidtours","V00003065","2018-11-30 08:56:56","voucher_expense"
"5c0098d60640335131f7bff0",74,78965,"Update agent voucher expense","TA","intrepidtours","V00003066","2018-11-30 08:56:38","voucher_expense"
"5c0098bd0640335131f7bfef",-310,78891,"Agent voucher expense","TA","intrepidtours","V00003070","2018-11-30 08:56:13","voucher_expense"
"5c0098a30640335131f7bfec",-124,79201,"Agent voucher expense","TA","intrepidtours","V00003069","2018-11-30 08:55:47","voucher_expense"
"5c00989691e6de138e183a3d",-682,79325,"Agent voucher expense","TA","intrepidtours","V00003068","2018-11-30 08:55:34","voucher_expense"
"5c00988991e6de138e183a3b",-496,80007,"Update agent voucher expense","TA","intrepidtours","V00003065","2018-11-30 08:55:21","voucher_expense"
"5c00988191e6de138e183a3a",-434,80503,"Agent voucher expense","TA","intrepidtours","V00003067","2018-11-30 08:55:13","voucher_expense"
"5c0098720640335131f7bfe6",-481,80937,"Agent voucher expense","TA","intrepidtours","V00003066","2018-11-30 08:54:58","voucher_expense"
"5c00984c0640335131f7bfe4",-333,81418,"Agent voucher expense","TA","intrepidtours","V00003065","2018-11-30 08:54:20","voucher_expense"
"5c0097e60640335131f7bfde",407,81751,"Update agent voucher expense","TA","intrepidtours","V00003043","2018-11-30 08:52:38","voucher_expense"
"5c0097cc0640335131f7bfdb",333,81344,"Update agent voucher expense","TA","intrepidtours","V00003042","2018-11-30 08:52:12","voucher_expense"
"5c00951091e6de138e183a04",275,81011,"Update agent voucher expense","TA","intrepidtours","V00003043","2018-11-30 08:40:32","voucher_expense"
"5c0095080640335131f7bfa8",-682,80736,"Agent voucher expense","TA","intrepidtours","V00003043","2018-11-30 08:40:24","voucher_expense"
"5c0094ef91e6de138e183a03",-333,81418,"Agent voucher expense","TA","intrepidtours","V00003042","2018-11-30 08:39:59","voucher_expense"
"5bff44520b363e4e3da199c8",10000,81751,"Make a deposit","TA","intrepidtours","ANZ.197212(29/11/18)","2018-11-29 08:43:46","deposit"
"5bff38e80b363e4e3da19942",10000,71751,"Make a deposit","TA","intrepidtours","ANZ","2018-11-29 07:55:04","deposit"
"5bfe53c95943944d2f6b44f7",-992,61751,"Agent voucher expense","TA","intrepidtours","V00003020","2018-11-28 15:37:29","voucher_expense"
"5bfe53c02f6539058fb30056",-248,62743,"Agent voucher expense","TA","intrepidtours","V00003019","2018-11-28 15:37:20","voucher_expense"
"5bfe53b02f6539058fb30054",-222,62991,"Agent voucher expense","TA","intrepidtours","V00003018","2018-11-28 15:37:04","voucher_expense"
"5bfdf03320a1da488d73d9ed",-496,63213,"Agent voucher expense","TA","intrepidtours","V00002996","2018-11-28 08:32:35","voucher_expense"
"5bfdf01c0f4b8e68790f2fcf",-62,63709,"Agent voucher expense","TA","intrepidtours","V00002995","2018-11-28 08:32:12","voucher_expense"
"5bfdf00c20a1da488d73d9ea",-296,63771,"Agent voucher expense","TA","intrepidtours","V00002994","2018-11-28 08:31:56","voucher_expense"
"5bfdeff620a1da488d73d9e6",-74,64067,"Agent voucher expense","TA","intrepidtours","V00002993","2018-11-28 08:31:34","voucher_expense"
"5bfbc7fb20a1da488d73d16d",-620,64141,"Agent voucher expense","TA","intrepidtours","V00002975","2018-11-26 17:16:27","voucher_expense"
"5bfbc7f00f4b8e68790f27bf",-124,64761,"Agent voucher expense","TA","intrepidtours","V00002974","2018-11-26 17:16:16","voucher_expense"
"5bfbc7e820a1da488d73d16b",-74,64885,"Agent voucher expense","TA","intrepidtours","V00002973","2018-11-26 17:16:08","voucher_expense"
"5bfb53b417bb2106b792f788",-558,64959,"Agent voucher expense","TA","intrepidtours","V00002922","2018-11-26 09:00:20","voucher_expense"
"5bfb537d4be5cf069dd153ca",-248,65517,"Agent voucher expense","TA","intrepidtours","V00002921","2018-11-26 08:59:25","voucher_expense"
"5bfb536e4be5cf069dd153c8",-296,65765,"Agent voucher expense","TA","intrepidtours","V00002920","2018-11-26 08:59:10","voucher_expense"
"5bfb535317bb2106b792f782",-148,66061,"Agent voucher expense","TA","intrepidtours","V00002919","2018-11-26 08:58:43","voucher_expense"
"5bfa0b514be5cf069dd1505f",-558,66209,"Agent voucher expense","TA","intrepidtours","V00002888","2018-11-25 09:39:13","voucher_expense"
"5bfa0b444be5cf069dd1505d",-124,66767,"Update agent voucher expense","TA","intrepidtours","V00002887","2018-11-25 09:39:00","voucher_expense"
"5bfa0b3b17bb2106b792f3e4",-62,66891,"Agent voucher expense","TA","intrepidtours","V00002887","2018-11-25 09:38:51","voucher_expense"
"5bfa0b2817bb2106b792f3e1",-370,66953,"Agent voucher expense","TA","intrepidtours","V00002886","2018-11-25 09:38:32","voucher_expense"
"5bfa0b154be5cf069dd1505c",-37,67323,"Agent voucher expense","TA","intrepidtours","V00002885","2018-11-25 09:38:13","voucher_expense"
"5bf7bdd04be5cf069dd14aa7",-185,67360,"Agent voucher expense","TA","intrepidtours","V00002863","2018-11-23 15:44:00","voucher_expense"
"5bf7bdbf17bb2106b792ed9a",-1178,67545,"Agent voucher expense","TA","intrepidtours","V00002862","2018-11-23 15:43:43","voucher_expense"
"5bf7bdaf17bb2106b792ed98",-992,68723,"Agent voucher expense","TA","intrepidtours","V00002861","2018-11-23 15:43:27","voucher_expense"
"5bf7bd9f4be5cf069dd14aa1",-806,69715,"Update agent voucher expense","TA","intrepidtours","V00002860","2018-11-23 15:43:11","voucher_expense"
"5bf7bd9417bb2106b792ed96",-620,70521,"Update agent voucher expense","TA","intrepidtours","V00002860","2018-11-23 15:43:00","voucher_expense"
"5bf7bd8617bb2106b792ed94",-620,71141,"Agent voucher expense","TA","intrepidtours","V00002860","2018-11-23 15:42:46","voucher_expense"
"5bf7bd7217bb2106b792ed91",-434,71761,"Agent voucher expense","TA","intrepidtours","V00002859","2018-11-23 15:42:26","voucher_expense"
"5bf7bd614be5cf069dd14a9c",-124,72195,"Update agent voucher expense","TA","intrepidtours","V00002857","2018-11-23 15:42:09","voucher_expense"
"5bf7bd584be5cf069dd14a9b",-124,72319,"Agent voucher expense","TA","intrepidtours","V00002858","2018-11-23 15:42:00","voucher_expense"
"5bf7bd4917bb2106b792ed8f",-124,72443,"Update agent voucher expense","TA","intrepidtours","V00002857","2018-11-23 15:41:45","voucher_expense"
"5bf7bd334be5cf069dd14a99",-62,72567,"Agent voucher expense","TA","intrepidtours","V00002857","2018-11-23 15:41:23","voucher_expense"
"5bf7bd2817bb2106b792ed8e",-370,72629,"Agent voucher expense","TA","intrepidtours","V00002856","2018-11-23 15:41:12","voucher_expense"
"5bf7bd1817bb2106b792ed8c",-185,72999,"Agent voucher expense","TA","intrepidtours","V00002855","2018-11-23 15:40:56","voucher_expense"
"5bf769f04be5cf069dd1495f",-868,73184,"Update agent voucher expense","TA","intrepidtours","V00002825","2018-11-23 09:46:08","voucher_expense"
"5bf769e04be5cf069dd1495e",-558,74052,"Agent voucher expense","TA","intrepidtours","V00002825","2018-11-23 09:45:52","voucher_expense"
"5bf769c94be5cf069dd1495b",-434,74610,"Agent voucher expense","TA","intrepidtours","V00002824","2018-11-23 09:45:29","voucher_expense"
"5bf769b817bb2106b792ec54",-444,75044,"Agent voucher expense","TA","intrepidtours","V00002823","2018-11-23 09:45:12","voucher_expense"
"5bf769a717bb2106b792ec52",-333,75488,"Agent voucher expense","TA","intrepidtours","V00002822","2018-11-23 09:44:55","voucher_expense"
"5bf769984be5cf069dd14959",-259,75821,"Update agent voucher expense","TA","intrepidtours","V00002820","2018-11-23 09:44:40","voucher_expense"
"5bf7698217bb2106b792ec50",-222,76080,"Agent voucher expense","TA","intrepidtours","V00002821","2018-11-23 09:44:18","voucher_expense"
"5bf7697a4be5cf069dd14958",-222,76302,"Agent voucher expense","TA","intrepidtours","V00002820","2018-11-23 09:44:10","voucher_expense"
"5bf51a4a17bb2106b792e741",-682,76524,"Update agent voucher expense","TA","intrepidtours","V00002793","2018-11-21 15:41:46","voucher_expense"
"5bf51a414be5cf069dd1440d",-496,77206,"Agent voucher expense","TA","intrepidtours","V00002793","2018-11-21 15:41:37","voucher_expense"
"5bf51a2a17bb2106b792e740",-186,77702,"Agent voucher expense","TA","intrepidtours","V00002792","2018-11-21 15:41:14","voucher_expense"
"5bf51a1017bb2106b792e73e",-444,77888,"Agent voucher expense","TA","intrepidtours","V00002791","2018-11-21 15:40:48","voucher_expense"
"5bf51a014be5cf069dd1440b",-185,78332,"Agent voucher expense","TA","intrepidtours","V00002790","2018-11-21 15:40:33","voucher_expense"
"5bf519e717bb2106b792e73c",-111,78517,"Agent voucher expense","TA","intrepidtours","V00002789","2018-11-21 15:40:07","voucher_expense"
"5bf4b8ad17bb2106b792e572",-930,78628,"Agent voucher expense","TA","intrepidtours","V00002765","2018-11-21 08:45:17","voucher_expense"
"5bf4b89b17bb2106b792e570",-496,79558,"Agent voucher expense","TA","intrepidtours","V00002764","2018-11-21 08:44:59","voucher_expense"
"5bf4b88917bb2106b792e56e",-124,80054,"Agent voucher expense","TA","intrepidtours","V00002763","2018-11-21 08:44:41","voucher_expense"
"5bf4b87917bb2106b792e56c",-407,80178,"Agent voucher expense","TA","intrepidtours","V00002762","2018-11-21 08:44:25","voucher_expense"
"5bf4b86817bb2106b792e56a",-222,80585,"Agent voucher expense","TA","intrepidtours","V00002761","2018-11-21 08:44:08","voucher_expense"
"5bf39f3aabc8b27dac99812e",-868,80807,"Agent voucher expense","TA","intrepidtours","V00002751","2018-11-20 12:44:26","voucher_expense"
"5bf39f2d76f97609f3bfb4f1",-372,81675,"Agent voucher expense","TA","intrepidtours","V00002750","2018-11-20 12:44:13","voucher_expense"
"5bf39dc0abc8b27dac998128",-124,82047,"Agent voucher expense","TA","intrepidtours","V00002749","2018-11-20 12:38:08","voucher_expense"
"5bf39db0abc8b27dac998126",-444,82171,"Agent voucher expense","TA","intrepidtours","V00002748","2018-11-20 12:37:52","voucher_expense"
"5bf39da2abc8b27dac998124",-222,82615,"Agent voucher expense","TA","intrepidtours","V00002747","2018-11-20 12:37:38","voucher_expense"
"5bf39d9176f97609f3bfb4e7",-74,82837,"Agent voucher expense","TA","intrepidtours","V00002746","2018-11-20 12:37:21","voucher_expense"
"5bf39d87abc8b27dac998122",-434,82911,"Agent voucher expense","TA","intrepidtours","V00002745","2018-11-20 12:37:11","voucher_expense"
"5bf3932976f97609f3bfb4c7",7000,83345,"Make a deposit","TA","intrepidtours","សាច់ប្រាក់","2018-11-20 11:52:57","deposit"
"5bf36d6c76f97609f3bfb331",-62,76345,"Update agent voucher expense","TA","intrepidtours","V00002703","2018-11-20 09:11:56","voucher_expense"
"5bf36d64abc8b27dac998019",-744,76407,"Agent voucher expense","TA","intrepidtours","V00002703","2018-11-20 09:11:48","voucher_expense"
"5bf36d5276f97609f3bfb330",-744,77151,"Update agent voucher expense","TA","intrepidtours","V00002701","2018-11-20 09:11:30","voucher_expense"
"5bf36d4376f97609f3bfb32a",-682,77895,"Agent voucher expense","TA","intrepidtours","V00002702","2018-11-20 09:11:15","voucher_expense"
"5bf36d3676f97609f3bfb328",-682,78577,"Agent voucher expense","TA","intrepidtours","V00002701","2018-11-20 09:11:02","voucher_expense"
"5bf36d2576f97609f3bfb325",-124,79259,"Agent voucher expense","TA","intrepidtours","V00002700","2018-11-20 09:10:45","voucher_expense"
"5bf36d1babc8b27dac998017",-62,79383,"Agent voucher expense","TA","intrepidtours","V00002699","2018-11-20 09:10:35","voucher_expense"
"5bf36d0d76f97609f3bfb323",-148,79445,"Agent voucher expense","TA","intrepidtours","V00002698","2018-11-20 09:10:21","voucher_expense"
"5bf3660876f97609f3bfb2b5",868,79593,"Update agent voucher expense","TA","intrepidtours","V00002657","2018-11-20 08:40:24","voucher_expense"
"5bf36603abc8b27dac997fc2",372,78725,"Update agent voucher expense","TA","intrepidtours","V00002656","2018-11-20 08:40:19","voucher_expense"
"5bf365fe76f97609f3bfb2b4",124,78353,"Update agent voucher expense","TA","intrepidtours","V00002655","2018-11-20 08:40:14","voucher_expense"
"5bf365f676f97609f3bfb2b3",444,78229,"Update agent voucher expense","TA","intrepidtours","V00002654","2018-11-20 08:40:06","voucher_expense"
"5bf365efabc8b27dac997fc1",222,77785,"Update agent voucher expense","TA","intrepidtours","V00002653","2018-11-20 08:39:59","voucher_expense"
"5bf365ea76f97609f3bfb2b2",74,77563,"Update agent voucher expense","TA","intrepidtours","V00002652","2018-11-20 08:39:54","voucher_expense"
"5bf365e5abc8b27dac997fc0",434,77489,"Update agent voucher expense","TA","intrepidtours","V00002651","2018-11-20 08:39:49","voucher_expense"
"5bf21b29abc8b27dac997712",-868,77055,"Agent voucher expense","TA","intrepidtours","V00002657","2018-11-19 09:08:41","voucher_expense"
"5bf21b0fabc8b27dac99770f",-372,77923,"Agent voucher expense","TA","intrepidtours","V00002656","2018-11-19 09:08:15","voucher_expense"
"5bf21afbabc8b27dac99770d",-124,78295,"Agent voucher expense","TA","intrepidtours","V00002655","2018-11-19 09:07:55","voucher_expense"
"5bf21ae9abc8b27dac99770b",-444,78419,"Agent voucher expense","TA","intrepidtours","V00002654","2018-11-19 09:07:37","voucher_expense"
"5bf219caabc8b27dac997702",-222,78863,"Agent voucher expense","TA","intrepidtours","V00002653","2018-11-19 09:02:50","voucher_expense"
"5bf219beabc8b27dac997700",-74,79085,"Agent voucher expense","TA","intrepidtours","V00002652","2018-11-19 09:02:38","voucher_expense"
"5bf219ab76f97609f3bfacc8",-434,79159,"Agent voucher expense","TA","intrepidtours","V00002651","2018-11-19 09:02:19","voucher_expense"
"5bf0c6b576f97609f3bfa93b",-111,79593,"Agent voucher expense","TA","intrepidtours","V00002622","2018-11-18 08:56:05","voucher_expense"
"5bf0c6a776f97609f3bfa939",-37,79704,"Agent voucher expense","TA","intrepidtours","V00002621","2018-11-18 08:55:51","voucher_expense"
"5bef73c376f97609f3bfa515",-992,79741,"Agent voucher expense","TA","intrepidtours","V00002585","2018-11-17 08:49:55","voucher_expense"
"5bef73a6abc8b27dac996fc4",-1178,80733,"Agent voucher expense","TA","intrepidtours","V00002584","2018-11-17 08:49:26","voucher_expense"
"5bef7392abc8b27dac996fc1",-992,81911,"Agent voucher expense","TA","intrepidtours","V00002583","2018-11-17 08:49:06","voucher_expense"
"5bef7383abc8b27dac996fbd",-248,82903,"Agent voucher expense","TA","intrepidtours","V00002582","2018-11-17 08:48:51","voucher_expense"
"5bef7377abc8b27dac996fb7",-496,83151,"Agent voucher expense","TA","intrepidtours","V00002581","2018-11-17 08:48:39","voucher_expense"
"5bef735676f97609f3bfa510",-259,83647,"Agent voucher expense","TA","intrepidtours","V00002580","2018-11-17 08:48:06","voucher_expense"
"5bef7346abc8b27dac996fb5",-37,83906,"Agent voucher expense","TA","intrepidtours","V00002579","2018-11-17 08:47:50","voucher_expense"
"5bef733e76f97609f3bfa50e",-148,83943,"Agent voucher expense","TA","intrepidtours","V00002578","2018-11-17 08:47:42","voucher_expense"
"5bef7331abc8b27dac996fb3",-148,84091,"Agent voucher expense","TA","intrepidtours","V00002577","2018-11-17 08:47:29","voucher_expense"
"5bee24cfabc8b27dac99657b",-496,84239,"Update agent voucher expense","TA","intrepidtours","V00002546","2018-11-16 09:00:47","voucher_expense"
"5bee24bf76f97609f3bf9bf8",-992,84735,"Agent voucher expense","TA","intrepidtours","V00002547","2018-11-16 09:00:31","voucher_expense"
"5bee24b0abc8b27dac99657a",-620,85727,"Update agent voucher expense","TA","intrepidtours","V00002546","2018-11-16 09:00:16","voucher_expense"
"5bee24a1abc8b27dac996579",-496,86347,"Agent voucher expense","TA","intrepidtours","V00002546","2018-11-16 09:00:01","voucher_expense"
"5bee249376f97609f3bf9bf6",-496,86843,"Agent voucher expense","TA","intrepidtours","V00002545","2018-11-16 08:59:47","voucher_expense"
"5bee247dabc8b27dac996577",-62,87339,"Agent voucher expense","TA","intrepidtours","V00002544","2018-11-16 08:59:25","voucher_expense"
"5bee246976f97609f3bf9bf4",-148,87401,"Agent voucher expense","TA","intrepidtours","V00002543","2018-11-16 08:59:05","voucher_expense"
"5bee245a76f97609f3bf9bf0",-148,87549,"Agent voucher expense","TA","intrepidtours","V00002542","2018-11-16 08:58:50","voucher_expense"
"5becd0b4abc8b27dac996125",-124,87697,"Agent voucher expense","TA","intrepidtours","V00002508","2018-11-15 08:49:40","voucher_expense"
"5becd0a7abc8b27dac996123",-124,87821,"Agent voucher expense","TA","intrepidtours","V00002507","2018-11-15 08:49:27","voucher_expense"
"5becd09976f97609f3bf979c",-62,87945,"Agent voucher expense","TA","intrepidtours","V00002506","2018-11-15 08:49:13","voucher_expense"
"5becd08babc8b27dac99611f",-296,88007,"Agent voucher expense","TA","intrepidtours","V00002505","2018-11-15 08:48:59","voucher_expense"
"5becd07776f97609f3bf9796",-148,88303,"Agent voucher expense","TA","intrepidtours","V00002504","2018-11-15 08:48:39","voucher_expense"
"5beb7bc6ad6df17d7323d5a2",-744,88451,"Agent voucher expense","TA","intrepidtours","V00002476","2018-11-14 08:35:02","voucher_expense"
"5beb7bb90634697b5208e454",-434,89195,"Agent voucher expense","TA","intrepidtours","V00002475","2018-11-14 08:34:49","voucher_expense"
"5beb7ba2ad6df17d7323d5a0",-434,89629,"Agent voucher expense","TA","intrepidtours","V00002474","2018-11-14 08:34:26","voucher_expense"
"5beb7b96ad6df17d7323d59c",-124,90063,"Agent voucher expense","TA","intrepidtours","V00002473","2018-11-14 08:34:14","voucher_expense"
"5beb7b8bad6df17d7323d59a",-111,90187,"Agent voucher expense","TA","intrepidtours","V00002472","2018-11-14 08:34:03","voucher_expense"
"5bea3da8ad6df17d7323d2a9",25000,90298,"Make a deposit","TA","intrepidtours","ANZ Bank""312653""(13/11/18)","2018-11-13 09:57:44","deposit"
"5bea2e720634697b5208e16a",-620,65298,"Agent voucher expense","TA","intrepidtours","V00002445","2018-11-13 08:52:50","voucher_expense"
"5bea2e5f0634697b5208e168",-62,65918,"Agent voucher expense","TA","intrepidtours","V00002444","2018-11-13 08:52:31","voucher_expense"
"5bea2e54fa1650783fabb75c",-37,65980,"Agent voucher expense","TA","intrepidtours","V00002443","2018-11-13 08:52:20","voucher_expense"
"5be8da650634697b5208dd5b",-124,66017,"Update agent voucher expense","TA","intrepidtours","V00002410","2018-11-12 08:41:57","voucher_expense"
"5be8da5c0634697b5208dd5a",-744,66141,"Agent voucher expense","TA","intrepidtours","V00002414","2018-11-12 08:41:48","voucher_expense"
"5be8da4dfa1650783fabb3f1",-620,66885,"Agent voucher expense","TA","intrepidtours","V00002413","2018-11-12 08:41:33","voucher_expense"
"5be8da3a0634697b5208dd54",-558,67505,"Agent voucher expense","TA","intrepidtours","V00002412","2018-11-12 08:41:14","voucher_expense"
"5be8da290634697b5208dd50",-372,68063,"Agent voucher expense","TA","intrepidtours","V00002411","2018-11-12 08:40:57","voucher_expense"
"5be8da16fa1650783fabb3ee",-124,68435,"Agent voucher expense","TA","intrepidtours","V00002410","2018-11-12 08:40:38","voucher_expense"
"5be8da050634697b5208dd4e",-62,68559,"Agent voucher expense","TA","intrepidtours","V00002409","2018-11-12 08:40:21","voucher_expense"
"5be8d9f60634697b5208dd4c",-407,68621,"Agent voucher expense","TA","intrepidtours","V00002408","2018-11-12 08:40:06","voucher_expense"
"5be8d9e80634697b5208dd4a",-148,69028,"Agent voucher expense","TA","intrepidtours","V00002407","2018-11-12 08:39:52","voucher_expense"
"5be79187fa1650783fabb121",-1054,69176,"Agent voucher expense","TA","intrepidtours","V00002375","2018-11-11 09:18:47","voucher_expense"
"5be791740634697b5208da86",-558,70230,"Agent voucher expense","TA","intrepidtours","V00002374","2018-11-11 09:18:28","voucher_expense"
"5be791620634697b5208da83",-62,70788,"Update agent voucher expense","TA","intrepidtours","V00002373","2018-11-11 09:18:10","voucher_expense"
"5be791570634697b5208da82",-37,70850,"Agent voucher expense","TA","intrepidtours","V00002373","2018-11-11 09:17:59","voucher_expense"
"5be7914cfa1650783fabb11f",-185,70887,"Agent voucher expense","TA","intrepidtours","V00002372","2018-11-11 09:17:48","voucher_expense"
"5be6387dfa1650783fabad02",-930,71072,"Agent voucher expense","TA","intrepidtours","V00002330","2018-11-10 08:46:37","voucher_expense"
"5be6386b0634697b5208d693",-620,72002,"Agent voucher expense","TA","intrepidtours","V00002329","2018-11-10 08:46:19","voucher_expense"
"5be63853fa1650783fabad00",-496,72622,"Agent voucher expense","TA","intrepidtours","V00002328","2018-11-10 08:45:55","voucher_expense"
"5be638460634697b5208d68e",-434,73118,"Agent voucher expense","TA","intrepidtours","V00002327","2018-11-10 08:45:42","voucher_expense"
"5be6381f0634697b5208d688",-333,73552,"Agent voucher expense","TA","intrepidtours","V00002326","2018-11-10 08:45:03","voucher_expense"
"5be6380a0634697b5208d686",-259,73885,"Update agent voucher expense","TA","intrepidtours","V00002325","2018-11-10 08:44:42","voucher_expense"
"5be63801fa1650783fabacfb",-37,74144,"Agent voucher expense","TA","intrepidtours","V00002325","2018-11-10 08:44:33","voucher_expense"
"5be4ea330634697b5208d348",-682,74181,"Agent voucher expense","TA","intrepidtours","V00002290","2018-11-09 09:00:19","voucher_expense"
"5be4ea250634697b5208d346",-806,74863,"Agent voucher expense","TA","intrepidtours","V00002289","2018-11-09 09:00:05","voucher_expense"
"5be4ea090634697b5208d342",-744,75669,"Agent voucher expense","TA","intrepidtours","V00002288","2018-11-09 08:59:37","voucher_expense"
"5be4e9f8fa1650783faba9c9",-222,76413,"Agent voucher expense","TA","intrepidtours","V00002287","2018-11-09 08:59:20","voucher_expense"
"5be4e9d90634697b5208d340",-124,76635,"Agent voucher expense","TA","intrepidtours","V00002286","2018-11-09 08:58:49","voucher_expense"
"5be4e9c5fa1650783faba9c7",-333,76759,"Agent voucher expense","TA","intrepidtours","V00002285","2018-11-09 08:58:29","voucher_expense"
"5be4e9a3fa1650783faba9c3",-37,77092,"Agent voucher expense","TA","intrepidtours","V00002284","2018-11-09 08:57:55","voucher_expense"
"5be4e9730634697b5208d33c",-222,77129,"Agent voucher expense","TA","intrepidtours","V00002283","2018-11-09 08:57:07","voucher_expense"
"5be4e9560634697b5208d338",-185,77351,"Agent voucher expense","TA","intrepidtours","V00002282","2018-11-09 08:56:38","voucher_expense"
"5be4e945fa1650783faba9bd",-185,77536,"Agent voucher expense","TA","intrepidtours","V00002281","2018-11-09 08:56:21","voucher_expense"
"5be392bdd632ad01d5aa29f3",-806,77721,"Agent voucher expense","TA","intrepidtours","V00002257","2018-11-08 08:34:53","voucher_expense"
"5be3925b1573a11251fd7bac",-248,78527,"Agent voucher expense","TA","intrepidtours","V00002256","2018-11-08 08:33:15","voucher_expense"
"5be391bed632ad01d5aa29e8",-296,78775,"Agent voucher expense","TA","intrepidtours","V00002255","2018-11-08 08:30:38","voucher_expense"
"5be391b1d632ad01d5aa29e6",-259,79071,"Agent voucher expense","TA","intrepidtours","V00002254","2018-11-08 08:30:25","voucher_expense"
"5be391a3d632ad01d5aa29e4",-74,79330,"Agent voucher expense","TA","intrepidtours","V00002253","2018-11-08 08:30:11","voucher_expense"
"5be23b901573a11251fd77dd",-992,79404,"Agent voucher expense","TA","intrepidtours","V00002224","2018-11-07 08:10:40","voucher_expense"
"5be23b731573a11251fd77da",-744,80396,"Agent voucher expense","TA","intrepidtours","V00002223","2018-11-07 08:10:11","voucher_expense"
"5be23b641573a11251fd77d8",-74,81140,"Agent voucher expense","TA","intrepidtours","V00002222","2018-11-07 08:09:56","voucher_expense"
"5be0f59baf8bc81a6b09189c",-806,81214,"Agent voucher expense","TA","intrepidtours","V00002191","2018-11-06 08:59:55","voucher_expense"
"5be0f58daf8bc81a6b09189a",-62,82020,"Agent voucher expense","TA","intrepidtours","V00002190","2018-11-06 08:59:41","voucher_expense"
"5be0f57eaf8bc81a6b091898",-148,82082,"Agent voucher expense","TA","intrepidtours","V00002189","2018-11-06 08:59:26","voucher_expense"
"5bdfa490dab95d6c35350987",-372,82230,"Agent voucher expense","TA","intrepidtours","V00002161","2018-11-05 09:01:52","voucher_expense"
"5bdfa484ff780d5355c4e6bc",-62,82602,"Agent voucher expense","TA","intrepidtours","V00002160","2018-11-05 09:01:40","voucher_expense"
"5bdfa17ddab95d6c35350978",-259,82664,"Agent voucher expense","TA","intrepidtours","V00002159","2018-11-05 08:48:45","voucher_expense"
"5bde4cb5dab95d6c35350668",-62,82923,"Agent voucher expense","TA","intrepidtours","V00002133","2018-11-04 08:34:45","voucher_expense"
"5bde4ca9dab95d6c35350665",-806,82985,"Agent voucher expense","TA","intrepidtours","V00002132","2018-11-04 08:34:33","voucher_expense"
"5bde4c79ff780d5355c4e3e1",-496,83791,"Agent voucher expense","TA","intrepidtours","V00002131","2018-11-04 08:33:45","voucher_expense"
"5bde4c6ddab95d6c35350663",-186,84287,"Update agent voucher expense","TA","intrepidtours","V00002129","2018-11-04 08:33:33","voucher_expense"
"5bde4c64ff780d5355c4e3df",-124,84473,"Agent voucher expense","TA","intrepidtours","V00002130","2018-11-04 08:33:24","voucher_expense"
"5bde4c54ff780d5355c4e3dd",-62,84597,"Agent voucher expense","TA","intrepidtours","V00002129","2018-11-04 08:33:08","voucher_expense"
"5bde4c3bdab95d6c35350661",-296,84659,"Update agent voucher expense","TA","intrepidtours","V00002128","2018-11-04 08:32:43","voucher_expense"
"5bde4c2fff780d5355c4e3da",-222,84955,"Agent voucher expense","TA","intrepidtours","V00002128","2018-11-04 08:32:31","voucher_expense"
"5bde4c16ff780d5355c4e3d6",-111,85177,"Agent voucher expense","TA","intrepidtours","V00002127","2018-11-04 08:32:06","voucher_expense"
"5bdd0163ff780d5355c4e13e",-1116,85288,"Agent voucher expense","TA","intrepidtours","V00002091","2018-11-03 09:01:07","voucher_expense"
"5bdd0151ff780d5355c4e13c",-744,86404,"Agent voucher expense","TA","intrepidtours","V00002090","2018-11-03 09:00:49","voucher_expense"
"5bdd0141dab95d6c3535039d",-682,87148,"Agent voucher expense","TA","intrepidtours","V00002089","2018-11-03 09:00:33","voucher_expense"
"5bdd0134ff780d5355c4e13a",-310,87830,"Agent voucher expense","TA","intrepidtours","V00002088","2018-11-03 09:00:20","voucher_expense"
"5bdd0125ff780d5355c4e136",-444,88140,"Agent voucher expense","TA","intrepidtours","V00002087","2018-11-03 09:00:05","voucher_expense"
"5bdd0119dab95d6c3535039b",-148,88584,"Agent voucher expense","TA","intrepidtours","V00002086","2018-11-03 08:59:53","voucher_expense"
"5bdbaec8dab95d6c35350035",-930,88732,"Agent voucher expense","TA","intrepidtours","V00002052","2018-11-02 08:56:24","voucher_expense"
"5bdbaeb9ff780d5355c4ddc1",-682,89662,"Agent voucher expense","TA","intrepidtours","V00002051","2018-11-02 08:56:09","voucher_expense"
"5bdbaea8ff780d5355c4ddbf",-248,90344,"Agent voucher expense","TA","intrepidtours","V00002050","2018-11-02 08:55:52","voucher_expense"
"5bdbae90ff780d5355c4ddbb",-124,90592,"Agent voucher expense","TA","intrepidtours","V00002049","2018-11-02 08:55:28","voucher_expense"
"5bdbae82dab95d6c35350033",-370,90716,"Agent voucher expense","TA","intrepidtours","V00002048","2018-11-02 08:55:14","voucher_expense"
"5bdbae62dab95d6c35350031",-185,91086,"Agent voucher expense","TA","intrepidtours","V00002047","2018-11-02 08:54:42","voucher_expense"
"5bdbae50dab95d6c3535002f",-148,91271,"Agent voucher expense","TA","intrepidtours","V00002046","2018-11-02 08:54:24","voucher_expense"
"5bda6f08dab95d6c3534fa1a",20000,91419,"Make a deposit","TA","intrepidtours","ANZ 197206","2018-11-01 10:12:08","deposit"
"5bda59dfff780d5355c4d9a5",-111,71419,"Agent voucher expense","TA","intrepidtours","V00002027","2018-11-01 08:41:51","voucher_expense"
"5bd9049eff780d5355c4d562",-558,71530,"Agent voucher expense","TA","intrepidtours","V00002011","2018-10-31 08:25:50","voucher_expense"
"5bd90491ff780d5355c4d560",-186,72088,"Agent voucher expense","TA","intrepidtours","V00002010","2018-10-31 08:25:37","voucher_expense"
"5bd9046cff780d5355c4d55d",-74,72274,"Agent voucher expense","TA","intrepidtours","V00002009","2018-10-31 08:25:00","voucher_expense"
"5bd7b501dab95d6c3534f2ef",-806,72348,"Agent voucher expense","TA","intrepidtours","V00001989","2018-10-30 08:33:53","voucher_expense"
"5bd7b4f1ff780d5355c4d173",-682,73154,"Agent voucher expense","TA","intrepidtours","V00001988","2018-10-30 08:33:37","voucher_expense"
"5bd7b4d8dab95d6c3534f2ed",-682,73836,"Agent voucher expense","TA","intrepidtours","V00001987","2018-10-30 08:33:12","voucher_expense"
"5bd684d2ff780d5355c4cf07",-868,74518,"Update agent voucher expense","TA","intrepidtours","V00001966","2018-10-29 10:56:02","voucher_expense"
"5bd684c4dab95d6c3534f0bd",37,75386,"Update agent voucher expense","TA","intrepidtours","V00001964","2018-10-29 10:55:48","voucher_expense"
"5bd684bfff780d5355c4cf06",-37,75349,"Update agent voucher expense","TA","intrepidtours","V00001966","2018-10-29 10:55:43","voucher_expense"
"5bd684b3dab95d6c3534f0bc",-124,75386,"Agent voucher expense","TA","intrepidtours","V00001966","2018-10-29 10:55:31","voucher_expense"
"5bd68489dab95d6c3534f0ba",-496,75510,"Agent voucher expense","TA","intrepidtours","V00001965","2018-10-29 10:54:49","voucher_expense"
"5bd6847fdab95d6c3534f0b7",-37,76006,"Update agent voucher expense","TA","intrepidtours","V00001964","2018-10-29 10:54:39","voucher_expense"
"5bd68473ff780d5355c4cf05",-37,76043,"Update agent voucher expense","TA","intrepidtours","V00001964","2018-10-29 10:54:27","voucher_expense"
"5bd68464dab95d6c3534f0b6",-222,76080,"Agent voucher expense","TA","intrepidtours","V00001964","2018-10-29 10:54:12","voucher_expense"
"5bd68451dab95d6c3534f0b4",-296,76302,"Agent voucher expense","TA","intrepidtours","V00001963","2018-10-29 10:53:53","voucher_expense"
"5bd6843eff780d5355c4cf04",-222,76598,"Agent voucher expense","TA","intrepidtours","V00001962","2018-10-29 10:53:34","voucher_expense"
"5bd68142ff780d5355c4cee8",-124,76820,"Agent voucher expense","TA","intrepidtours","V00001943","2018-10-29 10:40:50","voucher_expense"
"5bd6812adab95d6c3534f09f",-444,76944,"Agent voucher expense","TA","intrepidtours","V00001942","2018-10-29 10:40:26","voucher_expense"
"5bd68107ff780d5355c4cee6",-74,77388,"Agent voucher expense","TA","intrepidtours","V00001941","2018-10-29 10:39:51","voucher_expense"
"5bd67990ff780d5355c4ceb9",-248,77462,"Agent voucher expense","TA","intrepidtours","V00001919","2018-10-29 10:08:00","voucher_expense"
"5bd67939dab95d6c3534f064",-434,77710,"Agent voucher expense","TA","intrepidtours","V00001918","2018-10-29 10:06:33","voucher_expense"
"5bd67922dab95d6c3534f062",-259,78144,"Agent voucher expense","TA","intrepidtours","V00001917","2018-10-29 10:06:10","voucher_expense"
"5bd675e4ff780d5355c4ce93",-744,78403,"Update agent voucher expense","TA","intrepidtours","V00001898","2018-10-29 09:52:20","voucher_expense"
"5bd675d4dab95d6c3534f045",-248,79147,"Agent voucher expense","TA","intrepidtours","V00001898","2018-10-29 09:52:04","voucher_expense"
"5bd66ccadab95d6c3534f005",-682,79395,"Agent voucher expense","TA","intrepidtours","V00001879","2018-10-29 09:13:30","voucher_expense"
"5bd66cb8ff780d5355c4ce50",-370,80077,"Agent voucher expense","TA","intrepidtours","V00001878","2018-10-29 09:13:12","voucher_expense"
"5bd66ca1dab95d6c3534f001",-111,80447,"Agent voucher expense","TA","intrepidtours","V00001877","2018-10-29 09:12:49","voucher_expense"
"5bd51db7ff780d5355c4cb85",-620,80558,"Agent voucher expense","TA","intrepidtours","V00001853","2018-10-28 09:23:51","voucher_expense"
"5bd51c46ff780d5355c4cb70",620,81178,"Update agent voucher expense","TA","intrepidtours","V00001829","2018-10-28 09:17:42","voucher_expense"
"5bd51957dab95d6c3534ed2c",-620,80558,"Agent voucher expense","TA","intrepidtours","V00001829","2018-10-28 09:05:11","voucher_expense"
"5bd3c451dab95d6c3534e99e",-310,81178,"Agent voucher expense","TA","intrepidtours","V00001804","2018-10-27 08:50:09","voucher_expense"
"5bd3c43ddab95d6c3534e99c",-558,81488,"Agent voucher expense","TA","intrepidtours","V00001803","2018-10-27 08:49:49","voucher_expense"
"5bd3c422dab95d6c3534e99a",-62,82046,"Agent voucher expense","TA","intrepidtours","V00001802","2018-10-27 08:49:22","voucher_expense"
"5bd3c409dab95d6c3534e998",-185,82108,"Agent voucher expense","TA","intrepidtours","V00001801","2018-10-27 08:48:57","voucher_expense"
"5bcfdce7ff780d5355c4bc8d",5000,82293,"Make a deposit","TA","intrepidtours","ANZ 197204","2018-10-24 09:45:59","deposit"
"5bcd421dff780d5355c4b6ee",-620,77293,"Agent voucher expense","TA","intrepidtours","V00001771","2018-10-22 10:21:01","voucher_expense"
"5bcd420dff780d5355c4b6ec",-124,77913,"Agent voucher expense","TA","intrepidtours","V00001770","2018-10-22 10:20:45","voucher_expense"
"5bcd41fdff780d5355c4b6e5",-333,78037,"Agent voucher expense","TA","intrepidtours","V00001769","2018-10-22 10:20:29","voucher_expense"
"5bcd41ddff780d5355c4b6e3",-185,78370,"Agent voucher expense","TA","intrepidtours","V00001768","2018-10-22 10:19:57","voucher_expense"
"5bcd3becff780d5355c4b6b1",-868,78555,"Agent voucher expense","TA","intrepidtours","V00001741","2018-10-22 09:54:36","voucher_expense"
"5bcd3bd8dab95d6c3534d82d",-558,79423,"Agent voucher expense","TA","intrepidtours","V00001740","2018-10-22 09:54:16","voucher_expense"
"5bcd3bbbff780d5355c4b6ae",-124,79981,"Agent voucher expense","TA","intrepidtours","V00001739","2018-10-22 09:53:47","voucher_expense"
"5bcd3bacdab95d6c3534d82b",-259,80105,"Agent voucher expense","TA","intrepidtours","V00001738","2018-10-22 09:53:32","voucher_expense"
"5bcd3b9bdab95d6c3534d829",-74,80364,"Agent voucher expense","TA","intrepidtours","V00001737","2018-10-22 09:53:15","voucher_expense"
"5bca975bdab95d6c3534d2d5",-744,80438,"Agent voucher expense","TA","intrepidtours","V00001719","2018-10-20 09:47:55","voucher_expense"
"5bca9735ff780d5355c4b110",-248,81182,"Agent voucher expense","TA","intrepidtours","V00001718","2018-10-20 09:47:17","voucher_expense"
"5bca9709ff780d5355c4b10e",-62,81430,"Agent voucher expense","TA","intrepidtours","V00001717","2018-10-20 09:46:33","voucher_expense"
"5bca96a2dab95d6c3534d2cb",-407,81492,"Agent voucher expense","TA","intrepidtours","V00001716","2018-10-20 09:44:50","voucher_expense"
"5bca968fdab95d6c3534d2c8",-111,81899,"Agent voucher expense","TA","intrepidtours","V00001715","2018-10-20 09:44:31","voucher_expense"
"5bc9496ddab95d6c3534cecd",-868,82010,"Agent voucher expense","TA","intrepidtours","V00001690","2018-10-19 10:03:09","voucher_expense"
"5bc94957dab95d6c3534cecb",-992,82878,"Agent voucher expense","TA","intrepidtours","V00001689","2018-10-19 10:02:47","voucher_expense"
"5bc94947ff780d5355c4ab56",-682,83870,"Agent voucher expense","TA","intrepidtours","V00001688","2018-10-19 10:02:31","voucher_expense"
"5bc9492fdab95d6c3534cec9",-248,84552,"Agent voucher expense","TA","intrepidtours","V00001687","2018-10-19 10:02:07","voucher_expense"
"5bc94909ff780d5355c4ab53",-248,84800,"Agent voucher expense","TA","intrepidtours","V00001686","2018-10-19 10:01:29","voucher_expense"
"5bc948f4dab95d6c3534cec7",-186,85048,"Agent voucher expense","TA","intrepidtours","V00001685","2018-10-19 10:01:08","voucher_expense"
"5bc948d2dab95d6c3534cec5",-518,85234,"Agent voucher expense","TA","intrepidtours","V00001684","2018-10-19 10:00:34","voucher_expense"
"5bc948bcff780d5355c4ab51",-444,85752,"Agent voucher expense","TA","intrepidtours","V00001683","2018-10-19 10:00:12","voucher_expense"
"5bc948a8ff780d5355c4ab4f",-370,86196,"Agent voucher expense","TA","intrepidtours","V00001682","2018-10-19 09:59:52","voucher_expense"
"5bc9488cdab95d6c3534cec3",-259,86566,"Agent voucher expense","TA","intrepidtours","V00001681","2018-10-19 09:59:24","voucher_expense"
"5bc94872ff780d5355c4ab4d",-259,86825,"Agent voucher expense","TA","intrepidtours","V00001680","2018-10-19 09:58:58","voucher_expense"
"5bc7f3fedab95d6c3534cb86",-333,87084,"Agent voucher expense","TA","intrepidtours","V00001654","2018-10-18 09:46:22","voucher_expense"
"5bc6aeeaff780d5355c4a540",-333,87417,"Agent voucher expense","TA","intrepidtours","V00001637","2018-10-17 10:39:22","voucher_expense"
"5bc6aed2ff780d5355c4a53d",-74,87750,"Agent voucher expense","TA","intrepidtours","V00001636","2018-10-17 10:38:58","voucher_expense"
"5bc6aa8edab95d6c3534c848",-620,87824,"Agent voucher expense","TA","intrepidtours","V00001609","2018-10-17 10:20:46","voucher_expense"
"5bc6aa83ff780d5355c4a51b",-558,88444,"Agent voucher expense","TA","intrepidtours","V00001608","2018-10-17 10:20:35","voucher_expense"
"5bc6aa6bdab95d6c3534c846",-74,89002,"Agent voucher expense","TA","intrepidtours","V00001607","2018-10-17 10:20:11","voucher_expense"
"5bc6a4b1dab95d6c3534c815",-682,89076,"Agent voucher expense","TA","intrepidtours","V00001580","2018-10-17 09:55:45","voucher_expense"
"5bc6a4a3ff780d5355c4a4f3",-111,89758,"Agent voucher expense","TA","intrepidtours","V00001579","2018-10-17 09:55:31","voucher_expense"
"5bc69f92dab95d6c3534c7e0",-111,89869,"Agent voucher expense","TA","intrepidtours","V00001552","2018-10-17 09:33:54","voucher_expense"
"5bc59745dab95d6c3534c55d",15000,89980,"Make a deposit","TA","intrepidtours","ANZ""197203""(16/10/18)","2018-10-16 14:46:13","deposit"
"5bc1a15ddab95d6c3534bce5",-620,74980,"Agent voucher expense","TA","intrepidtours","V00001528","2018-10-13 14:40:13","voucher_expense"
"5bc1a144dab95d6c3534bce3",-372,75600,"Agent voucher expense","TA","intrepidtours","V00001527","2018-10-13 14:39:48","voucher_expense"
"5bc1a130ff780d5355c49af0",-444,75972,"Agent voucher expense","TA","intrepidtours","V00001526","2018-10-13 14:39:28","voucher_expense"
"5bc1a115ff780d5355c49aee",-222,76416,"Agent voucher expense","TA","intrepidtours","V00001525","2018-10-13 14:39:01","voucher_expense"
"5bc1a0fcdab95d6c3534bce1",-37,76638,"Agent voucher expense","TA","intrepidtours","V00001524","2018-10-13 14:38:36","voucher_expense"
"5bc19c5ddab95d6c3534bcc0",-868,76675,"Agent voucher expense","TA","intrepidtours","V00001503","2018-10-13 14:18:53","voucher_expense"
"5bc19c4fdab95d6c3534bcbe",-558,77543,"Agent voucher expense","TA","intrepidtours","V00001502","2018-10-13 14:18:39","voucher_expense"
"5bc19c3eff780d5355c49ad3",-124,78101,"Agent voucher expense","TA","intrepidtours","V00001501","2018-10-13 14:18:22","voucher_expense"
"5bbf01b3ff780d5355c494ab",-620,78225,"Agent voucher expense","TA","intrepidtours","V00001477","2018-10-11 14:54:27","voucher_expense"
"5bbf019dff780d5355c494a9",-124,78845,"Agent voucher expense","TA","intrepidtours","V00001476","2018-10-11 14:54:05","voucher_expense"
"5bbf0181dab95d6c3534b6cd",-185,78969,"Agent voucher expense","TA","intrepidtours","V00001475","2018-10-11 14:53:37","voucher_expense"
"5bbd6c1ce74d446a03073194",-124,79154,"Agent voucher expense","TA","intrepidtours","V00001448","2018-10-10 10:03:56","voucher_expense"
"5bbd6c0ce74d446a03073192",-37,79278,"Agent voucher expense","TA","intrepidtours","V00001447","2018-10-10 10:03:40","voucher_expense"
"5bbd68eee74d446a03073177",-620,79315,"Agent voucher expense","TA","intrepidtours","V00001424","2018-10-10 09:50:22","voucher_expense"
"5bbac8030e663774b87dd65e",-682,79935,"Agent voucher expense","TA","intrepidtours","V00001398","2018-10-08 09:59:15","voucher_expense"
"5bbac7ed0e663774b87dd65c",-620,80617,"Agent voucher expense","TA","intrepidtours","V00001397","2018-10-08 09:58:53","voucher_expense"
"5bbac7dce74d446a03072e47",-259,81237,"Agent voucher expense","TA","intrepidtours","V00001396","2018-10-08 09:58:36","voucher_expense"
"5bbac7c60e663774b87dd65a",-296,81496,"Agent voucher expense","TA","intrepidtours","V00001395","2018-10-08 09:58:14","voucher_expense"
"5bbac270e74d446a03072e14",-124,81792,"Agent voucher expense","TA","intrepidtours","V00001365","2018-10-08 09:35:28","voucher_expense"
"5bbac24fe74d446a03072e12",-592,81916,"Agent voucher expense","TA","intrepidtours","V00001364","2018-10-08 09:34:55","voucher_expense"
"5bbac235e74d446a03072e0e",-370,82508,"Agent voucher expense","TA","intrepidtours","V00001363","2018-10-08 09:34:29","voucher_expense"
"5bbabc5d0e663774b87dd5ed",-1054,82878,"Agent voucher expense","TA","intrepidtours","V00001341","2018-10-08 09:09:33","voucher_expense"
"5bbabc41e74d446a03072dd7",-620,83932,"Agent voucher expense","TA","intrepidtours","V00001340","2018-10-08 09:09:05","voucher_expense"
"5bbabc2e0e663774b87dd5eb",-310,84552,"Agent voucher expense","TA","intrepidtours","V00001339","2018-10-08 09:08:46","voucher_expense"
"5bbabc140e663774b87dd5e9",-248,84862,"Agent voucher expense","TA","intrepidtours","V00001338","2018-10-08 09:08:20","voucher_expense"
"5bbabbfae74d446a03072dd5",-259,85110,"Agent voucher expense","TA","intrepidtours","V00001337","2018-10-08 09:07:54","voucher_expense"
"5bbabbe90e663774b87dd5e6",-296,85369,"Agent voucher expense","TA","intrepidtours","V00001336","2018-10-08 09:07:37","voucher_expense"
"5bb72f5d0e663774b87dcfab",-682,85665,"Agent voucher expense","TA","intrepidtours","V00001309","2018-10-05 16:31:09","voucher_expense"
"5bb72eb50e663774b87dcfa7",-496,86347,"Agent voucher expense","TA","intrepidtours","V00001308","2018-10-05 16:28:21","voucher_expense"
"5bb72e9be74d446a03072772",-370,86843,"Agent voucher expense","TA","intrepidtours","V00001307","2018-10-05 16:27:55","voucher_expense"
"5bb5d56b0e663774b87dcc9b",-992,87213,"Agent voucher expense","TA","intrepidtours","V00001258","2018-10-04 15:55:07","voucher_expense"
"5bb5d55ae74d446a03072467",-185,88205,"Agent voucher expense","TA","intrepidtours","V00001257","2018-10-04 15:54:50","voucher_expense"
"5bb5d305e74d446a03072452",50,88390,"Update agent voucher expense","TA","intrepidtours","V00001255","2018-10-04 15:44:53","voucher_expense"
"5bb5d2e1e74d446a0307244e",-496,88340,"Agent voucher expense","TA","intrepidtours","V00001256","2018-10-04 15:44:17","voucher_expense"
"5bb5d2d2e74d446a0307244c",-124,88836,"Agent voucher expense","TA","intrepidtours","V00001255","2018-10-04 15:44:02","voucher_expense"
"5bb5d28b0e663774b87dcc91",-372,88960,"Agent voucher expense","TA","intrepidtours","V00001254","2018-10-04 15:42:51","voucher_expense"
"5bb5d277e74d446a03072449",-620,89332,"Agent voucher expense","TA","intrepidtours","V00001253","2018-10-04 15:42:31","voucher_expense"
"5bb5d2620e663774b87dcc8f",-620,89952,"Agent voucher expense","TA","intrepidtours","V00001252","2018-10-04 15:42:10","voucher_expense"
"5bb5d2430e663774b87dcc8d",-111,90572,"Agent voucher expense","TA","intrepidtours","V00001251","2018-10-04 15:41:39","voucher_expense"
"5bb5d1ffe74d446a03072447",-620,90683,"Agent voucher expense","TA","intrepidtours","V00001250","2018-10-04 15:40:31","voucher_expense"
"5bb5d1f30e663774b87dcc8b",-620,91303,"Agent voucher expense","TA","intrepidtours","V00001249","2018-10-04 15:40:19","voucher_expense"
"5bb5d1e50e663774b87dcc89",-620,91923,"Agent voucher expense","TA","intrepidtours","V00001248","2018-10-04 15:40:05","voucher_expense"
"5bb57d870e663774b87dcaef",-124,92543,"Agent voucher expense","TA","intrepidtours","V00001229","2018-10-04 09:40:07","voucher_expense"
"5bb57d6ee74d446a03072342",-148,92667,"Agent voucher expense","TA","intrepidtours","V00001228","2018-10-04 09:39:42","voucher_expense"
"5bb3400be74d446a03071dbe",-496,92815,"Agent voucher expense","TA","intrepidtours","V00001209","2018-10-02 16:53:15","voucher_expense"
"5bb33ffa0e663774b87dc4f2",-185,93311,"Agent voucher expense","TA","intrepidtours","V00001208","2018-10-02 16:52:58","voucher_expense"
"5bb2e7970e663774b87dc396",-186,93496,"Agent voucher expense","TA","intrepidtours","V00001191","2018-10-02 10:35:51","voucher_expense"
"5bb2e784e74d446a03071c8f",-620,93682,"Agent voucher expense","TA","intrepidtours","V00001190","2018-10-02 10:35:32","voucher_expense"
"5bb2e7700e663774b87dc394",-558,94302,"Agent voucher expense","TA","intrepidtours","V00001189","2018-10-02 10:35:12","voucher_expense"
"5bb2e7590e663774b87dc392",-496,94860,"Agent voucher expense","TA","intrepidtours","V00001188","2018-10-02 10:34:49","voucher_expense"
"5bb2e740e74d446a03071c8d",-124,95356,"Agent voucher expense","TA","intrepidtours","V00001187","2018-10-02 10:34:24","voucher_expense"
"5bb2e7340e663774b87dc390",-124,95480,"Agent voucher expense","TA","intrepidtours","V00001186","2018-10-02 10:34:12","voucher_expense"
"5bb2e7150e663774b87dc38e",-74,95604,"Agent voucher expense","TA","intrepidtours","V00001185","2018-10-02 10:33:41","voucher_expense"
"5bb2e663e74d446a03071c86",20000,95678,"Make a deposit","TA","intrepidtours","ANZ 197202","2018-10-02 10:30:43","deposit"
"5bab4dc00e663774b87db2ec",-434,75678,"Agent voucher expense","TA","intrepidtours","V00001168","2018-09-26 16:13:36","voucher_expense"
"5baaf1660e663774b87db1a4",-62,76112,"Agent voucher expense","TA","intrepidtours","V00001151","2018-09-26 09:39:34","voucher_expense"
"5baaf156e74d446a03070bba",-74,76174,"Agent voucher expense","TA","intrepidtours","V00001150","2018-09-26 09:39:18","voucher_expense"
"5baaf146e74d446a03070bb8",-37,76248,"Agent voucher expense","TA","intrepidtours","V00001149","2018-09-26 09:39:02","voucher_expense"
"5ba8b89f0e663774b87dace1",-930,76285,"Agent voucher expense","TA","intrepidtours","V00001125","2018-09-24 17:12:47","voucher_expense"
"5ba8b87de74d446a03070779",-62,77215,"Agent voucher expense","TA","intrepidtours","V00001124","2018-09-24 17:12:13","voucher_expense"
"5ba8b8660e663774b87dacdd",-185,77277,"Agent voucher expense","TA","intrepidtours","V00001123","2018-09-24 17:11:50","voucher_expense"
"5ba875ae0e663774b87dac16",-868,77462,"Agent voucher expense","TA","intrepidtours","V00001096","2018-09-24 12:27:10","voucher_expense"
"5ba8759f0e663774b87dac14",-434,78330,"Agent voucher expense","TA","intrepidtours","V00001095","2018-09-24 12:26:55","voucher_expense"
"5ba8757ee74d446a030706d5",-111,78764,"Agent voucher expense","TA","intrepidtours","V00001094","2018-09-24 12:26:22","voucher_expense"
"5ba871310e663774b87dabf7",-518,78875,"Agent voucher expense","TA","intrepidtours","V00001068","2018-09-24 12:08:01","voucher_expense"
"5ba4c0dae74d446a030700c4",-496,79393,"Agent voucher expense","TA","intrepidtours","V00001025","2018-09-21 16:58:50","voucher_expense"
"5ba4c0bc0e663774b87da5dc",-407,79889,"Agent voucher expense","TA","intrepidtours","V00001024","2018-09-21 16:58:20","voucher_expense"
"5ba4c09e0e663774b87da5da",-259,80296,"Agent voucher expense","TA","intrepidtours","V00001023","2018-09-21 16:57:50","voucher_expense"
"5ba45c15e74d446a0306ff75",-310,80555,"Agent voucher expense","TA","intrepidtours","V00001000","2018-09-21 09:48:53","voucher_expense"
"5ba45bf7e74d446a0306ff73",-222,80865,"Agent voucher expense","TA","intrepidtours","V00000999","2018-09-21 09:48:23","voucher_expense"
"5ba45bbf0e663774b87da46d",-74,81087,"Agent voucher expense","TA","intrepidtours","V00000998","2018-09-21 09:47:27","voucher_expense"
"5ba45b96e74d446a0306ff6d",-37,81161,"Agent voucher expense","TA","intrepidtours","V00000997","2018-09-21 09:46:46","voucher_expense"
"5ba34dd40e663774b87da2cc",-248,81198,"Agent voucher expense","TA","intrepidtours","V00000974","2018-09-20 14:35:48","voucher_expense"
"5ba34dbf0e663774b87da2ca",-62,81446,"Agent voucher expense","TA","intrepidtours","V00000973","2018-09-20 14:35:27","voucher_expense"
"5ba34da80e663774b87da2c8",-124,81508,"Agent voucher expense","TA","intrepidtours","V00000972","2018-09-20 14:35:04","voucher_expense"
"5ba34d7fe74d446a0306fd30",-37,81632,"Agent voucher expense","TA","intrepidtours","V00000971","2018-09-20 14:34:23","voucher_expense"
"5ba2ffdde74d446a0306fbe3",10000,81669,"Make a deposit","TA","intrepidtours","ANZ.073431(18/09/18)","2018-09-20 09:03:09","deposit"
"5b9f78210e663774b87d99b7",-930,71669,"Agent voucher expense","TA","intrepidtours","V00000809","2018-09-17 16:47:13","voucher_expense"
"5b9f78110e663774b87d99b5",-868,72599,"Agent voucher expense","TA","intrepidtours","V00000808","2018-09-17 16:46:57","voucher_expense"
"5b9f7801e74d446a0306f44e",-62,73467,"Agent voucher expense","TA","intrepidtours","V00000807","2018-09-17 16:46:41","voucher_expense"
"5b9f77ebe74d446a0306f449",-259,73529,"Agent voucher expense","TA","intrepidtours","V00000806","2018-09-17 16:46:19","voucher_expense"
"5b9f5688e74d446a0306f3a6",-310,73788,"Agent voucher expense","TA","intrepidtours","V00000784","2018-09-17 14:23:52","voucher_expense"
"5b9f566a0e663774b87d9923",-111,74098,"Agent voucher expense","TA","intrepidtours","V00000783","2018-09-17 14:23:22","voucher_expense"
"5b9f564e0e663774b87d9921",-74,74209,"Agent voucher expense","TA","intrepidtours","V00000782","2018-09-17 14:22:54","voucher_expense"
"5b9f563a0e663774b87d991f",-37,74283,"Agent voucher expense","TA","intrepidtours","V00000781","2018-09-17 14:22:34","voucher_expense"
"5b9cd058e74d446a0306eec4",-62,74320,"Agent voucher expense","TA","intrepidtours","V00000718","2018-09-15 16:26:48","voucher_expense"
"5b9cd03e0e663774b87d944f",-148,74382,"Agent voucher expense","TA","intrepidtours","V00000717","2018-09-15 16:26:22","voucher_expense"
"5b9b83f20e663774b87d9147",-372,74530,"Agent voucher expense","TA","intrepidtours","V00000695","2018-09-14 16:48:34","voucher_expense"
"5b9b83ad0e663774b87d9143",-407,74902,"Agent voucher expense","TA","intrepidtours","V00000694","2018-09-14 16:47:25","voucher_expense"
"5b9b83820e663774b87d913f",-74,75309,"Agent voucher expense","TA","intrepidtours","V00000693","2018-09-14 16:46:42","voucher_expense"
"5b9a303b0e663774b87d8e0b",-744,75383,"Agent voucher expense","TA","intrepidtours","V00000649","2018-09-13 16:39:07","voucher_expense"
"5b9a3027e74d446a0306e93d",-806,76127,"Agent voucher expense","TA","intrepidtours","V00000648","2018-09-13 16:38:47","voucher_expense"
"5b9a30080e663774b87d8e09",-37,76933,"Agent voucher expense","TA","intrepidtours","V00000647","2018-09-13 16:38:16","voucher_expense"
"5b9a17f20e663774b87d8d5e",-310,76970,"Agent voucher expense","TA","intrepidtours","V00000599","2018-09-13 14:55:30","voucher_expense"
"5b97879ae74d446a0306e3f6",-124,77280,"Agent voucher expense","TA","intrepidtours","V00000570","2018-09-11 16:15:06","voucher_expense"
"5b9787780e663774b87d87bf",-111,77404,"Agent voucher expense","TA","intrepidtours","V00000569","2018-09-11 16:14:32","voucher_expense"
"5b963dcf778a1b1192d791bc",-100,77515,"Update agent voucher expense","TA","intrepidtours","V00000547","2018-09-10 16:47:59","voucher_expense"
"5b963d72778a1b1192d791bb",-930,77615,"Agent voucher expense","TA","intrepidtours","V00000548","2018-09-10 16:46:26","voucher_expense"
"5b963d33778a1b1192d791b8",-148,78545,"Agent voucher expense","TA","intrepidtours","V00000547","2018-09-10 16:45:23","voucher_expense"
"5b963d08778a1b1192d791b6",-74,78693,"Agent voucher expense","TA","intrepidtours","V00000546","2018-09-10 16:44:40","voucher_expense"
"5b95e89e9a300f22027c1936",-496,78767,"Agent voucher expense","TA","intrepidtours","V00000481","2018-09-10 10:44:30","voucher_expense"
"5b95e88a21d64b146f7eb4ce",-124,79263,"Agent voucher expense","TA","intrepidtours","V00000480","2018-09-10 10:44:10","voucher_expense"
"5b95e8039a300f22027c192c",-124,79387,"Agent voucher expense","TA","intrepidtours","V00000479","2018-09-10 10:41:55","voucher_expense"
"5b95e7f921d64b146f7eb4cc",-111,79511,"Agent voucher expense","TA","intrepidtours","V00000478","2018-09-10 10:41:45","voucher_expense"
"5b95e7ec9a300f22027c192a",-74,79622,"Agent voucher expense","TA","intrepidtours","V00000477","2018-09-10 10:41:32","voucher_expense"
"5b95e70d21d64b146f7eb4bc",-434,79696,"Agent voucher expense","TA","intrepidtours","V00000464","2018-09-10 10:37:49","voucher_expense"
"5b95e7059a300f22027c191d",-434,80130,"Agent voucher expense","TA","intrepidtours","V00000463","2018-09-10 10:37:41","voucher_expense"
"5b95e6f79a300f22027c191b",-111,80564,"Agent voucher expense","TA","intrepidtours","V00000462","2018-09-10 10:37:27","voucher_expense"
"5b95e50c9a300f22027c1905",-124,80675,"Agent voucher expense","TA","intrepidtours","V00000449","2018-09-10 10:29:16","voucher_expense"
"5b95e4fa9a300f22027c1901",-74,80799,"Agent voucher expense","TA","intrepidtours","V00000447","2018-09-10 10:28:58","voucher_expense"
"5b95e4949a300f22027c18fb",-558,80873,"Agent voucher expense","TA","intrepidtours","V00000442","2018-09-10 10:27:16","voucher_expense"
"5b95e48721d64b146f7eb49e",-444,81431,"Agent voucher expense","TA","intrepidtours","V00000440","2018-09-10 10:27:03","voucher_expense"
"5b95e0c69a300f22027c18be",496,81875,"Update agent voucher expense","TA","intrepidtours","V00000394","2018-09-10 10:11:02","voucher_expense"
"5b95e0729a300f22027c18bd",-496,81379,"Agent voucher expense","TA","intrepidtours","V00000394","2018-09-10 10:09:38","voucher_expense"
"5b95dfd321d64b146f7eb45e",-496,81875,"Agent voucher expense","TA","intrepidtours","V00000392","2018-09-10 10:06:59","voucher_expense"
"5b95dfc49a300f22027c18bb",-310,82371,"Agent voucher expense","TA","intrepidtours","V00000391","2018-09-10 10:06:44","voucher_expense"
"5b95dfb621d64b146f7eb45c",-248,82681,"Agent voucher expense","TA","intrepidtours","V00000389","2018-09-10 10:06:30","voucher_expense"
"5b95dfa321d64b146f7eb45a",-124,82929,"Agent voucher expense","TA","intrepidtours","V00000387","2018-09-10 10:06:11","voucher_expense"
"5b95df9621d64b146f7eb458",-259,83053,"Agent voucher expense","TA","intrepidtours","V00000386","2018-09-10 10:05:58","voucher_expense"
"5b95df8b9a300f22027c18b5",-222,83312,"Agent voucher expense","TA","intrepidtours","V00000385","2018-09-10 10:05:47","voucher_expense"
"5b95df6021d64b146f7eb456",-370,83534,"Agent voucher expense","TA","intrepidtours","V00000384","2018-09-10 10:05:04","voucher_expense"
"5b95ddb19a300f22027c1897",-111,83904,"Agent voucher expense","TA","intrepidtours","V00000363","2018-09-10 09:57:53","voucher_expense"
"5b95dda221d64b146f7eb43d",-74,84015,"Agent voucher expense","TA","intrepidtours","V00000362","2018-09-10 09:57:38","voucher_expense"
"5b95d4d89a300f22027c1854",-744,84089,"Agent voucher expense","TA","intrepidtours","V00000326","2018-09-10 09:20:08","voucher_expense"
"5b95d4cb9a300f22027c1852",-558,84833,"Agent voucher expense","TA","intrepidtours","V00000325","2018-09-10 09:19:55","voucher_expense"
"5b95d4be21d64b146f7eb3fa",-124,85391,"Agent voucher expense","TA","intrepidtours","V00000324","2018-09-10 09:19:42","voucher_expense"
"5b95d4ae21d64b146f7eb3f8",-222,85515,"Agent voucher expense","TA","intrepidtours","V00000323","2018-09-10 09:19:26","voucher_expense"
"5b95d47821d64b146f7eb3f6",-37,85737,"Agent voucher expense","TA","intrepidtours","V00000322","2018-09-10 09:18:32","voucher_expense"
"5b8f3e71e324af59effd7f92",15000,85774,"Make a deposit","TA","intrepidtours","ANZ 073528","2018-09-05 09:24:49","deposit"
"5b7fc42b939fad5641699455",-124,70774,"Agent voucher expense","TA","intrepidtours","V00000125","2018-08-24 15:39:07","voucher_expense"
"5b7fc3c9a0d64f61e8d11cc8",-62,70898,"Agent voucher expense","TA","intrepidtours","V00000124","2018-08-24 15:37:29","voucher_expense"
"5b7fc3a4a0d64f61e8d11cc6",-496,70960,"Agent voucher expense","TA","intrepidtours","V00000123","2018-08-24 15:36:52","voucher_expense"
"5b7fc393939fad5641699453",-558,71456,"Agent voucher expense","TA","intrepidtours","V00000122","2018-08-24 15:36:35","voucher_expense"
"5b7fc383a0d64f61e8d11cc4",-111,72014,"Agent voucher expense","TA","intrepidtours","V00000121","2018-08-24 15:36:19","voucher_expense"
"5b7fc373a0d64f61e8d11cc2",-37,72125,"Agent voucher expense","TA","intrepidtours","V00000120","2018-08-24 15:36:03","voucher_expense"
"5b7fc1c6939fad564169944d",-868,72162,"Agent voucher expense","TA","intrepidtours","V00000119","2018-08-24 15:28:54","voucher_expense"
"5b7fc1b7a0d64f61e8d11cbe",-62,73030,"Agent voucher expense","TA","intrepidtours","V00000118","2018-08-24 15:28:39","voucher_expense"
"5b7fc194a0d64f61e8d11cbc",-62,73092,"Agent voucher expense","TA","intrepidtours","V00000117","2018-08-24 15:28:04","voucher_expense"
"5b7fc178a0d64f61e8d11cb7",-407,73154,"Agent voucher expense","TA","intrepidtours","V00000116","2018-08-24 15:27:36","voucher_expense"
"5b7fc164939fad5641699447",-296,73561,"Agent voucher expense","TA","intrepidtours","V00000115","2018-08-24 15:27:16","voucher_expense"
"5b7fc155939fad5641699445",-37,73857,"Agent voucher expense","TA","intrepidtours","V00000114","2018-08-24 15:27:01","voucher_expense"
"5b7fc13a939fad5641699443",-259,73894,"Agent voucher expense","TA","intrepidtours","V00000113","2018-08-24 15:26:34","voucher_expense"
"5b7fc0e1939fad5641699440",-259,74153,"Agent voucher expense","TA","intrepidtours","V00000112","2018-08-24 15:25:05","voucher_expense"
"5b7fc0ce939fad564169943d",-868,74412,"Agent voucher expense","TA","intrepidtours","V00000111","2018-08-24 15:24:46","voucher_expense"
"5b7fc0bda0d64f61e8d11cb4",-248,75280,"Agent voucher expense","TA","intrepidtours","V00000110","2018-08-24 15:24:29","voucher_expense"
"5b7fc0a8939fad564169943a",-444,75528,"Agent voucher expense","TA","intrepidtours","V00000109","2018-08-24 15:24:08","voucher_expense"
"5b7fc094a0d64f61e8d11caf",-259,75972,"Agent voucher expense","TA","intrepidtours","V00000108","2018-08-24 15:23:48","voucher_expense"
"5b7fc086939fad5641699438",-111,76231,"Agent voucher expense","TA","intrepidtours","V00000107","2018-08-24 15:23:34","voucher_expense"
"5b7fc06ca0d64f61e8d11cad",-148,76342,"Agent voucher expense","TA","intrepidtours","V00000106","2018-08-24 15:23:08","voucher_expense"
"5b7fc048939fad5641699434",-186,76490,"Agent voucher expense","TA","intrepidtours","V00000105","2018-08-24 15:22:32","voucher_expense"
"5b7fc035a0d64f61e8d11ca9",-111,76676,"Agent voucher expense","TA","intrepidtours","V00000104","2018-08-24 15:22:13","voucher_expense"
"5b7fc02aa0d64f61e8d11ca7",-806,76787,"Agent voucher expense","TA","intrepidtours","V00000103","2018-08-24 15:22:02","voucher_expense"
"5b7fc016939fad564169942e",-744,77593,"Agent voucher expense","TA","intrepidtours","V00000102","2018-08-24 15:21:42","voucher_expense"
"5b7fbff8a0d64f61e8d11ca5",-296,78337,"Agent voucher expense","TA","intrepidtours","V00000101","2018-08-24 15:21:12","voucher_expense"
"5b7fbf61a0d64f61e8d11ca3",-296,78633,"Agent voucher expense","TA","intrepidtours","V00000100","2018-08-24 15:18:41","voucher_expense"
"5b7fbf14939fad564169941d",-992,78929,"Agent voucher expense","TA","intrepidtours","V00000099","2018-08-24 15:17:24","voucher_expense"
"5b7fbed0a0d64f61e8d11c9b",-259,79921,"Agent voucher expense","TA","intrepidtours","V00000098","2018-08-24 15:16:16","voucher_expense"
"5b7fbe5da0d64f61e8d11c98",-248,80180,"Agent voucher expense","TA","intrepidtours","V00000097","2018-08-24 15:14:21","voucher_expense"
"5b7fbe51a0d64f61e8d11c96",-333,80428,"Agent voucher expense","TA","intrepidtours","V00000096","2018-08-24 15:14:09","voucher_expense"
"5b7fbdfca0d64f61e8d11c93",-930,80761,"Agent voucher expense","TA","intrepidtours","V00000095","2018-08-24 15:12:44","voucher_expense"
"5b7fbde2939fad5641699416",-222,81691,"Agent voucher expense","TA","intrepidtours","V00000094","2018-08-24 15:12:18","voucher_expense"
"5b7fbc86939fad5641699410",-74,81913,"Agent voucher expense","TA","intrepidtours","V00000093","2018-08-24 15:06:30","voucher_expense"
"5b7fbc71a0d64f61e8d11c88",-310,81987,"Agent voucher expense","TA","intrepidtours","V00000092","2018-08-24 15:06:09","voucher_expense"
"5b7fbc5aa0d64f61e8d11c86",-186,82297,"Agent voucher expense","TA","intrepidtours","V00000091","2018-08-24 15:05:46","voucher_expense"
"5b7fbc3da0d64f61e8d11c83",-62,82483,"Agent voucher expense","TA","intrepidtours","V00000090","2018-08-24 15:05:17","voucher_expense"
"5b7e3596a0d64f61e8d118b4",15000,82545,"Make a deposit","TA","intrepidtours","ANZ 073430","2018-08-23 11:18:30","deposit"
"5b7a2d04a0d64f61e8d10eeb",10000,67545,"Make a deposit","TA","intrepidtours","2018-08-16","2018-08-20 09:52:52","deposit"
"5b7a2cf8a0d64f61e8d10ee8",10000,57545,"Make a deposit","TA","intrepidtours","2018-08-08","2018-08-20 09:52:40","deposit"
"5b7a2ceba0d64f61e8d10ee5",10000,47545,"Make a deposit","TA","intrepidtours","2018-07-26","2018-08-20 09:52:27","deposit"
"5b7a2cdea0d64f61e8d10ee2",10000,37545,"Make a deposit","TA","intrepidtours","2018-07-19","2018-08-20 09:52:14","deposit"
"5b7a2cd1939fad5641698652",10000,27545,"Make a deposit","TA","intrepidtours","2018-07-11","2018-08-20 09:52:01","deposit"
"5b7a2cb2939fad564169864f",5000,17545,"Make a deposit","TA","intrepidtours","2018-07-03","2018-08-20 09:51:30","deposit"
"5b76349366f17f3242456b56",12527,12545,"Make a deposit","TA","intrepidtours","D","2018-08-17 09:36:03","deposit"
"5acd630b182f610e09384d82",18,18,"សួស្តីឆ្នាំថ្មី!
ក្នុងឱកាសបុណ្យចូលឆ្នាំថ្មីប្រពៃណីជាតិខ្មែរ លោកអ្នកទទួលបាន ១៨ដុល្លារបន្ថែមនៅក្នុងគណនីរបស់លោកអ្នក។​","TA","intrepidtours","promotion","2018-04-11 08:21:15","promotion"
